10MM	10mm		NOUN-Number=Sing
12's	12'		NOUN-Number=Plur
17th	17th		NOUN-Number=Sing
1990s	1990		NOUN-Number=Plur
19th	19th		NOUN-Number=Sing
22nd	22nd		NOUN-Number=Sing
22th	22th		NOUN-Number=Sing
29th	29th		NOUN-Number=Sing
3G	3g		NOUN-Number=Sing
3rd	3rd		NOUN-Number=Sing
4105SF	4105sf		NOUN-Number=Sing
47K202!.DOC	47k202!.doc		NOUN-Number=Sing
4th	4th		NOUN-Number=Sing
5th	5th		NOUN-Number=Sing
70's	70'		NOUN-Number=Plur
80's	80'		NOUN-Number=Plur
a	a		DET-Definite=Ind|PronType=Art
abducted	abduct		VERB-Tense=Past|VerbForm=Part|Voice=Pass
able	able		ADJ-Degree=Pos
about	about		ADJ-Degree=Pos
about	about		ADP
about	about		ADV
about	about		SCONJ
abouts	about		NOUN-Number=Plur
above	above		ADV
absolutely	absolutely		ADV
abuse	abuse		VERB-VerbForm=Inf
academic	academic		ADJ-Degree=Pos
acceptable	acceptable		ADJ-Degree=Pos
access	access		NOUN-Number=Sing
access	access		VERB-VerbForm=Inf
accident	accident		NOUN-Number=Sing
accomplishments	accomplishment		NOUN-Number=Plur
according	accord		VERB-VerbForm=Ger
account	account		NOUN-Number=Sing
accounting	accounting		NOUN-Number=Sing
accurate	accurate		ADJ-Degree=Pos
accuses	accuse		VERB-Mood=Ind|Number=Sing|Person=3|Tense=Pres|VerbForm=Fin
aches	ache		NOUN-Number=Plur
acquired	acquire		VERB-Tense=Past|VerbForm=Part
acquiring	acquire		VERB-VerbForm=Ger
acquisition	acquisition		NOUN-Number=Sing
across	across		ADP
across	across		ADV
act	act		VERB-VerbForm=Inf
acted	act		VERB-Tense=Past|VerbForm=Part|Voice=Pass
acting	act		VERB-Tense=Pres|VerbForm=Part
acting	act		VERB-VerbForm=Ger
action	action		NOUN-Number=Sing
actively	actively		ADV
activities	activity		NOUN-Number=Plur
activity	activity		NOUN-Number=Sing
acts	act		NOUN-Number=Plur
actually	actually		ADV
adage	adage		NOUN-Number=Sing
add	add		VERB-VerbForm=Inf
added	add		VERB-Mood=Ind|Tense=Past|VerbForm=Fin
added	add		VERB-Tense=Past|VerbForm=Part
adding	add		VERB-VerbForm=Ger
addition	addition		NOUN-Number=Sing
additional	additional		ADJ-Degree=Pos
address	address		NOUN-Number=Sing
addressed	address		VERB-Tense=Past|VerbForm=Part|Voice=Pass
adds	add		VERB-Mood=Ind|Number=Sing|Person=3|Tense=Pres|VerbForm=Fin
administartion	administartion		NOUN-Number=Sing
administration	administration		NOUN-Number=Sing
administrative	administrative		ADJ-Degree=Pos
administrator	administrator		NOUN-Number=Sing
admit	admit		VERB-VerbForm=Inf
admitted	admit		VERB-Mood=Ind|Tense=Past|VerbForm=Fin
ads	ad		NOUN-Number=Plur
advance	advance		VERB-VerbForm=Inf
advanced	advance		VERB-Mood=Ind|Tense=Past|VerbForm=Fin
advancement	advancement		NOUN-Number=Sing
adverse	adverse		ADJ-Degree=Pos
advice	advice		NOUN-Number=Sing
advice	advice		VERB-Mood=Imp|VerbForm=Fin
advice	advice		VERB-VerbForm=Inf
adviser	adviser		NOUN-Number=Sing
advocates	advocate		NOUN-Number=Plur
affair	affair		NOUN-Number=Sing
affairs	affair		NOUN-Number=Plur
affection	affection		NOUN-Number=Sing
affectionate	affectionate		ADJ-Degree=Pos
affiliates	affiliate		NOUN-Number=Plur
affliction	affliction		NOUN-Number=Sing
afflictions	affliction		NOUN-Number=Plur
affordable	affordable		ADJ-Degree=Pos
afford	afford		VERB-VerbForm=Inf
afnd	and		CCONJ
after	after		ADP
after	after		ADV
after	after		SCONJ
afternoon	afternoon		NOUN-Number=Sing
again	again		ADV
against	against		ADP
age	age		NOUN-Number=Sing
aged	aged		ADJ-Degree=Pos
aged	age		VERB-Tense=Past|VerbForm=Part
agencies	agency		NOUN-Number=Plur
agency	agency		NOUN-Number=Sing
agenda	agenda		NOUN-Number=Sing
agent	agent		NOUN-Number=Sing
agents	agent		NOUN-Number=Plur
aggression	aggression		NOUN-Number=Sing
ago	ago		ADV
agreeable	agreeable		ADJ-Degree=Pos
agree	agree		VERB-VerbForm=Inf
agreement	agreement		NOUN-Number=Sing
agreements	agreement		NOUN-Number=Plur
ahead	ahead		ADV
aid	aid		VERB-VerbForm=Inf
aide	aide		NOUN-Number=Sing
air	air		NOUN-Number=Sing
airfare	airfare		NOUN-Number=Sing
airline	airline		NOUN-Number=Sing
airlines	airline		NOUN-Number=Plur
airpart	airpart		NOUN-Number=Sing
airport	airport		NOUN-Number=Sing
album	album		NOUN-Number=Sing
alcohol	alcohol		NOUN-Number=Sing
alike	alike		ADJ-Degree=Pos
alive	alive		ADJ-Degree=Pos
all	all		ADV
all	all		DET
all	all		NOUN-Number=Sing
allege	allege		VERB-Mood=Ind|Tense=Pres|VerbForm=Fin
alleged	allege		VERB-Mood=Ind|Tense=Past|VerbForm=Fin
allergies	allergy		NOUN-Number=Plur
allies	ally		NOUN-Number=Plur
allow	allow		VERB-VerbForm=Inf
allowed	allow		VERB-Tense=Past|VerbForm=Part|Voice=Pass
almost	almost		ADV
alone	alone		ADJ-Degree=Pos
alone	alone		ADV
along	along		ADP
already	already		ADV
also	also		ADV
alt.animals.breeders.rabbits	alt.animals.breeders.rabbits		NOUN-Number=Sing
alt.animals.cat	alt.animals.cat		NOUN-Number=Sing
alt.animals.crab	alt.animals.crab		NOUN-Number=Sing
alt.animals.dog	alt.animals.dog		NOUN-Number=Sing
alt.animals.dogs.collies.open-forum	alt.animals.dogs.collies.open-forum		NOUN-Number=Sing
alt.animals.dolphins	alt.animals.dolphins		NOUN-Number=Sing
alt.animals.eagle.bald	alt.animals.eagle.bald		NOUN-Number=Sing
alt.animals.ethics.vegetarian	alt.animals.ethics.vegetarian		NOUN-Number=Sing
alt.animals.falcon	alt.animals.falcon		NOUN-Number=Sing
alter	alter		VERB-VerbForm=Inf
alternates	alternate		NOUN-Number=Plur
alternative	alternative		ADJ-Degree=Pos
alternative	alternative		NOUN-Number=Sing
although	although		SCONJ
always	always		ADV
a.m.	a.m.		NOUN-Number=Sing
amazing	amazing		ADJ-Degree=Pos
am	be		AUX-Mood=Ind|Number=Sing|Person=1|Tense=Pres|VerbForm=Fin
ambience	ambience		NOUN-Number=Sing
amendments	amendment		NOUN-Number=Plur
amenities	amenity		NOUN-Number=Plur
american	american		ADJ-Degree=Pos
ammazing	ammazing		ADJ-Degree=Pos
among	among		ADP
amount	amount		NOUN-Number=Sing
amounts	amount		NOUN-Number=Plur
amplifiaed	amplifia		VERB-Tense=Past|VerbForm=Part
amt	amt		NOUN-Number=Sing
an	a		DET-Definite=Ind|PronType=Art
analysis	analysis		NOUN-Number=Sing
analyst	analyst		NOUN-Number=Sing
and	and		CCONJ
anecdotes	anecdote		NOUN-Number=Plur
animal	animal		NOUN-Number=Sing
animals	animal		NOUN-Number=Plur
anniversary	anniversary		NOUN-Number=Sing
annotations	annotation		NOUN-Number=Plur
annoucement	annoucement		NOUN-Number=Sing
announced	announce		VERB-Mood=Ind|Tense=Past|VerbForm=Fin
announced	announce		VERB-Tense=Past|VerbForm=Part
announcement	announcement		NOUN-Number=Sing
another	another		DET
anothers	another		NOUN-Number=Plur
answer	answer		NOUN-Number=Sing
answered	answer		VERB-Mood=Ind|Tense=Past|VerbForm=Fin
answers	answer		VERB-Mood=Ind|Number=Sing|Person=3|Tense=Pres|VerbForm=Fin
anticipate	anticipate		VERB-Mood=Ind|Tense=Pres|VerbForm=Fin
anticipated	anticipate		VERB-Tense=Past|VerbForm=Part
anticipating	anticipate		VERB-VerbForm=Ger
anti-smoker	anti-smoker		NOUN-Number=Sing
any	any		DET
anybody	anybody		PRON-Number=Sing
anyone	anyone		PRON-Number=Sing
anyplace	anyplace		ADV
anything	anything		PRON-Number=Sing
anywhere	anywhere		ADV
apartment	apartment		NOUN-Number=Sing
apologize	apologize		VERB-Mood=Ind|Tense=Pres|VerbForm=Fin
apparently	apparently		ADV
appeal	appeal		NOUN-Number=Sing
appear	appear		VERB-VerbForm=Inf
appeared	appear		VERB-Tense=Past|VerbForm=Part
appetitie	appetitie		NOUN-Number=Sing
appliances	appliance		NOUN-Number=Plur
applying	apply		VERB-VerbForm=Ger
appologies	appology		NOUN-Number=Plur
appreciate	appreciate		VERB-Mood=Ind|Tense=Pres|VerbForm=Fin
appreciate	appreciate		VERB-VerbForm=Inf
appreciated	appreciate		VERB-Tense=Past|VerbForm=Part
appreciated	appreciate		VERB-Tense=Past|VerbForm=Part|Voice=Pass
apprised	apprised		ADJ-Degree=Pos
appropriate	appropriate		ADJ-Degree=Pos
approval	approval		NOUN-Number=Sing
approved	approve		VERB-Tense=Past|VerbForm=Part
approximately	approximately		ADV
apt	apt		ADJ-Degree=Pos
arab	arab		ADJ-Degree=Pos
arabes	arabes		NOUN-Number=Sing
architecture	architecture		NOUN-Number=Sing
archive	archive		NOUN-Number=Sing
area	area		NOUN-Number=Sing
area's	area'		NOUN-Number=Plur
areas	area		NOUN-Number=Plur
are	be		AUX-Mood=Ind|Tense=Pres|VerbForm=Fin
are	be		VERB-Mood=Ind|Tense=Pres|VerbForm=Fin
argentinian	argentinian		ADJ-Degree=Pos
argue	argue		VERB-VerbForm=Inf
arguments	argument		NOUN-Number=Plur
arises	arise		VERB-Mood=Ind|Number=Sing|Person=3|Tense=Pres|VerbForm=Fin
arm	arm		NOUN-Number=Sing
army	army		NOUN-Number=Sing
around	around		ADP
around	around		ADV
arrest	arrest		NOUN-Number=Sing
arrest	arrest		VERB-VerbForm=Inf
arrested	arrest		VERB-Mood=Ind|Tense=Past|VerbForm=Fin
arrested	arrest		VERB-Tense=Past|VerbForm=Part|Voice=Pass
arrests	arrest		NOUN-Number=Plur
arrive	arrive		VERB-Mood=Ind|Tense=Pres|VerbForm=Fin
arrived	arrive		VERB-Mood=Ind|Tense=Past|VerbForm=Fin
art	art		NOUN-Number=Sing
article	article		NOUN-Number=Sing
articles	article		NOUN-Number=Plur
artisan	artisan		NOUN-Number=Sing
as	as		ADP
as	as		ADV
as	as		SCONJ
ashamed	ashamed		ADJ-Degree=Pos
ask	ask		VERB-Mood=Imp|VerbForm=Fin
ask	ask		VERB-Mood=Ind|Tense=Pres|VerbForm=Fin
ask	ask		VERB-VerbForm=Inf
asked	ask		VERB-Tense=Past|VerbForm=Part
asked	ask		VERB-Tense=Past|VerbForm=Part|Voice=Pass
asking	ask		VERB-VerbForm=Ger
aspected	aspect		VERB-Tense=Past|VerbForm=Part
assassinate	assassinate		VERB-VerbForm=Inf
assassination	assassination		NOUN-Number=Sing
ass	ass		NOUN-Number=Sing
assault	assault		NOUN-Number=Sing
asses	ass		NOUN-Number=Plur
asset	asset		NOUN-Number=Sing
assist	assist		VERB-VerbForm=Inf
associate	associate		ADJ-Degree=Pos
assortment	assortment		NOUN-Number=Sing
assume	assume		VERB-Mood=Ind|Tense=Pres|VerbForm=Fin
astronaut's	astronaut'		NOUN-Number=Plur
astronauts	astronaut		NOUN-Number=Plur
at	at		ADP
at	at		ADV
at	at		SCONJ
ate	eat		VERB-Mood=Ind|Tense=Past|VerbForm=Fin
atmosphere	atmosphere		NOUN-Number=Sing
attached	attached		ADJ-Degree=Pos
attached	attach		VERB-Tense=Past|VerbForm=Part
attached	attach		VERB-Tense=Past|VerbForm=Part|Voice=Pass
attachments	attachment		NOUN-Number=Plur
attack	attack		NOUN-Number=Sing
attack	attack		VERB-Mood=Ind|Tense=Pres|VerbForm=Fin
attacked	attack		VERB-Mood=Ind|Tense=Past|VerbForm=Fin
attacked	attack		VERB-Tense=Past|VerbForm=Part
attacks	attack		NOUN-Number=Plur
attempted	attempt		VERB-Mood=Ind|Tense=Past|VerbForm=Fin
attendant	attendant		NOUN-Number=Sing
attend	attend		VERB-VerbForm=Inf
attention	attention		NOUN-Number=Sing
attentive	attentive		ADJ-Degree=Pos
attn	attn		NOUN-Number=Sing
attorney	attorney		NOUN-Number=Sing
attracted	attract		VERB-Tense=Past|VerbForm=Part
attractions	attraction		NOUN-Number=Plur
auction	auction		NOUN-Number=Sing
audiobooks	audiobook		NOUN-Number=Plur
audit	audit		VERB-VerbForm=Inf
auhtority	auhtority		NOUN-Number=Sing
authentic	authentic		ADJ-Degree=Pos
author	author		NOUN-Number=Sing
authority	authority		NOUN-Number=Sing
auto	auto		NOUN-Number=Sing
autobiography	autobiography		NOUN-Number=Sing
automatic	automatic		ADJ-Degree=Pos
available	available		ADJ-Degree=Pos
average	average		ADJ-Degree=Pos
awarded	award		VERB-Tense=Past|VerbForm=Part
away	away		ADP
away	away		ADV
away	away		NOUN-Number=Sing
aways	aways		ADV
awesome	awesome		ADJ-Degree=Pos
awful	awful		ADJ-Degree=Pos
aye	aye		INTJ
back	back		ADP
back	back		ADV
back	back		NOUN-Number=Sing
background	background		NOUN-Number=Sing
backup	backup		NOUN-Number=Sing
backyard	backyard		NOUN-Number=Sing
bacon	bacon		NOUN-Number=Sing
bad	bad		ADJ-Degree=Pos
badger	badger		NOUN-Number=Sing
bagels	bagel		NOUN-Number=Plur
baiting	baiting		NOUN-Number=Plur
baker	baker		NOUN-Number=Sing
balls	ball		NOUN-Number=Plur
ban	ban		VERB-Mood=Ind|Tense=Pres|VerbForm=Fin
ban	ban		VERB-VerbForm=Inf
band	band		NOUN-Number=Sing
bang	bang		NOUN-Number=Sing
bank	bank		NOUN-Number=Sing
banners	banner		NOUN-Number=Plur
bar	bar		NOUN-Number=Sing
bare	bare		ADJ-Degree=Pos
bark	bark		NOUN-Number=Sing
barrel	barrel		NOUN-Number=Sing
barrels	barrel		NOUN-Number=Plur
barrier	barrier		NOUN-Number=Sing
barring	bar		VERB-VerbForm=Ger
base	base		NOUN-Number=Sing
based	base		VERB-Tense=Past|VerbForm=Part
based	base		VERB-Tense=Past|VerbForm=Part|Voice=Pass
basement	basement		NOUN-Number=Sing
basically	basically		ADV
basis	basis		NOUN-Number=Sing
battery	battery		NOUN-Number=Sing
battle	battle		NOUN-Number=Sing
battlefield	battlefield		NOUN-Number=Sing
battles	battle		NOUN-Number=Plur
b/c	because		ADP-Abbr=Yes
b/c	because		SCONJ-Abbr=Yes
bc	because		SCONJ-Abbr=Yes
beach	beach		NOUN-Number=Sing
beans	bean		NOUN-Number=Plur
beat	beat		VERB-Tense=Past|VerbForm=Part
beat	beat		VERB-VerbForm=Inf
beating	beating		NOUN-Number=Sing
beautiful	beautiful		ADJ-Degree=Pos
be	be		AUX-Mood=Imp|VerbForm=Fin
be	be		AUX-VerbForm=Inf
be	be		VERB-VerbForm=Inf
because	because		ADP
because	because		SCONJ
become	become		VERB-Tense=Past|VerbForm=Part
become	become		VERB-VerbForm=Inf
bed	bed		NOUN-Number=Sing
bedeviling	bedevil		VERB-VerbForm=Ger
bedroom	bedroom		NOUN-Number=Sing
beef	beef		NOUN-Number=Sing
been	be		AUX-Tense=Past|VerbForm=Part
been	be		VERB-Tense=Past|VerbForm=Part
beer	beer		NOUN-Number=Sing
before	before		ADP
before	before		ADV
before	before		SCONJ
began	begin		VERB-Mood=Ind|Tense=Past|VerbForm=Fin
begin	begin		VERB-VerbForm=Inf
beginning	begin		VERB-VerbForm=Ger
behalf	behalf		NOUN-Number=Sing
behavioral	behavioral		ADJ-Degree=Pos
behead	behead		VERB-VerbForm=Inf
behind	behind		ADP
being	be		AUX-VerbForm=Ger
being	being		NOUN-Number=Sing
believe	believe		VERB-Mood=Ind|Tense=Pres|VerbForm=Fin
bellow	bellow		ADV
belongings	belongings		NOUN-Number=Plur
below	below		ADV
belt	belt		NOUN-Number=Sing
belts	belt		NOUN-Number=Plur
besides	besides		ADP
best	best		ADJ-Degree=Sup
best	best		ADV-Degree=Sup
better	better		ADJ-Degree=Cmp
better	better		ADV-Degree=Cmp
between	between		ADP
beware	beware		VERB-Mood=Imp|VerbForm=Fin
beyond	beyond		ADP
bid	bid		NOUN-Number=Sing
bid	bid		VERB-Mood=Ind|Tense=Past|VerbForm=Fin
big	big		ADJ-Degree=Pos
bike	bike		NOUN-Number=Sing
bilateral	bilateral		ADJ-Degree=Pos
billboards	billboard		NOUN-Number=Plur
biology	biology		NOUN-Number=Sing
bird	bird		NOUN-Number=Sing
birding	birding		NOUN-Number=Sing
birds	bird		NOUN-Number=Plur
birthday	birthday		NOUN-Number=Sing
bit	bit		NOUN-Number=Sing
bitches	bitch		NOUN-Number=Plur
bite	bite		NOUN-Number=Sing
black	black		ADJ-Degree=Pos
black	black		NOUN-Number=Sing
blanket	blanket		NOUN-Number=Sing
blanks	blank		NOUN-Number=Plur
blast	blast		NOUN-Number=Sing
blasts	blast		NOUN-Number=Plur
blessed	blessed		ADJ-Degree=Pos
blessed	bless		VERB-Tense=Past|VerbForm=Part
block	block		NOUN-Number=Sing
blockers	blocker		NOUN-Number=Plur
blog	blog		VERB-VerbForm=Inf
blogger	blogger		NOUN-Number=Sing
blood	blood		NOUN-Number=Sing
blouvard	blouvard		NOUN-Number=Sing
blow	blow		VERB-VerbForm=Inf
blowing	blow		VERB-Tense=Pres|VerbForm=Part
blown	blow		VERB-Tense=Past|VerbForm=Part
blu	blu		NOUN-Number=Sing
blue	blue		ADJ-Degree=Pos
blue	blue		NOUN-Number=Sing
board	board		NOUN-Number=Sing
boat	boat		NOUN-Number=Sing
bode	bode		VERB-VerbForm=Inf
body	body		NOUN-Number=Sing
boil	boil		VERB-Mood=Imp|VerbForm=Fin
bomb	bomb		NOUN-Number=Sing
bombed	bomb		VERB-Tense=Past|VerbForm=Part|Voice=Pass
boob	boob		VERB-VerbForm=Inf
book	book		NOUN-Number=Sing
book	book		VERB-VerbForm=Inf
booked	book		VERB-Mood=Ind|Tense=Past|VerbForm=Fin
booking	booking		NOUN-Number=Sing
books	book		NOUN-Number=Plur
border	border		NOUN-Number=Sing
born	born		ADJ-Degree=Pos
botched	botch		VERB-Tense=Past|VerbForm=Part
both	both		ADV
both	both		CCONJ
both	both		DET
bother	bother		VERB-VerbForm=Inf
bottling	bottling		NOUN-Number=Sing
bottom	bottom		NOUN-Number=Sing
bountiful	bountiful		ADJ-Degree=Pos
bowl	bowl		NOUN-Number=Sing
box	box		NOUN-Number=Sing
box	box		VERB-Mood=Ind|Tense=Pres|VerbForm=Fin
box	box		VERB-VerbForm=Inf
boy	boy		NOUN-Number=Sing
boycott	boycott		NOUN-Number=Sing
boyfriend	boyfriend		NOUN-Number=Sing
boys	boy		NOUN-Number=Plur
bpd	bpd		NOUN-Number=Sing
branching	branch		VERB-VerbForm=Ger
brave	brave		ADJ-Degree=Pos
break	break		VERB-VerbForm=Inf
breakfast	breakfast		NOUN-Number=Sing
breakfasts	breakfast		NOUN-Number=Plur
breaking	break		VERB-VerbForm=Ger
breakthrough	breakthrough		NOUN-Number=Sing
breeding	breed		VERB-VerbForm=Ger
bride	bride		NOUN-Number=Sing
bridge	bridge		NOUN-Number=Sing
bridges	bridge		NOUN-Number=Plur
briefly	briefly		ADV
bright	bright		ADJ-Degree=Pos
bring	bring		VERB-Mood=Ind|Tense=Pres|VerbForm=Fin
bring	bring		VERB-VerbForm=Inf
brings	bring		VERB-Mood=Ind|Number=Sing|Person=3|Tense=Pres|VerbForm=Fin
broccoli	broccoli		NOUN-Number=Sing
broke	break		VERB-Mood=Ind|Tense=Past|VerbForm=Fin
broker	broker		NOUN-Number=Sing
browned	browned		ADJ-Degree=Pos
browse	browse		VERB-VerbForm=Inf
browser	browser		NOUN-Number=Sing
browsing	browsing		NOUN-Number=Sing
brushing	brush		VERB-VerbForm=Ger
brute	brute		NOUN-Number=Sing
btw	btw		ADV
btw	btw		INTJ
buck	buck		NOUN-Number=Sing
budget	budget		NOUN-Number=Sing
buffet	buffet		NOUN-Number=Sing
building	building		NOUN-Number=Sing
building	build		VERB-Tense=Pres|VerbForm=Part
building	build		VERB-VerbForm=Ger
built	build		VERB-Mood=Ind|Tense=Past|VerbForm=Fin
bulk	bulk		VERB-Mood=Ind|Tense=Pres|VerbForm=Fin
bunch	bunch		NOUN-Number=Sing
bureaucratic	bureaucratic		ADJ-Degree=Pos
burger	burger		NOUN-Number=Sing
burn	burn		VERB-Mood=Imp|VerbForm=Fin
bus	bus		NOUN-Number=Sing
buses	bus		NOUN-Number=Plur
business	business		NOUN-Number=Sing
busy	busy		ADJ-Degree=Pos
but	but		ADP
but	but		CCONJ
butt	butt		NOUN-Number=Sing
buy	buy		VERB-Mood=Imp|VerbForm=Fin
buy	buy		VERB-Mood=Ind|Tense=Pres|VerbForm=Fin
buy	buy		VERB-VerbForm=Inf
by	by		ADP
by	by		ADV
by	by		SCONJ
cabins	cabin		NOUN-Number=Plur
cable	cable		NOUN-Number=Sing
cabs	cab		NOUN-Number=Plur
ca	can		AUX-VerbForm=Fin
cadmium	cadmium		NOUN-Number=Sing
cage	cage		NOUN-Number=Sing
cakes	cake		NOUN-Number=Plur
calculate	calculate		VERB-VerbForm=Inf
calculating	calculate		VERB-VerbForm=Ger
call	call		NOUN-Number=Sing
call	call		VERB-Mood=Imp|VerbForm=Fin
call	call		VERB-Mood=Ind|Tense=Pres|VerbForm=Fin
call	call		VERB-VerbForm=Inf
called	call		VERB-Mood=Ind|Tense=Past|VerbForm=Fin
called	call		VERB-Tense=Past|VerbForm=Part
called	call		VERB-Tense=Past|VerbForm=Part|Voice=Pass
calling	call		VERB-Tense=Pres|VerbForm=Part
calling	call		VERB-VerbForm=Ger
calls	call		NOUN-Number=Plur
calmed	calm		VERB-Mood=Ind|Tense=Past|VerbForm=Fin
came	come		VERB-Mood=Ind|Tense=Past|VerbForm=Fin
camera	camera		NOUN-Number=Sing
campaign	campaign		NOUN-Number=Sing
camp	camp		NOUN-Number=Sing
can	can		AUX-VerbForm=Fin
cancel	cancel		VERB-VerbForm=Inf
cancelled	cancel		VERB-Tense=Past|VerbForm=Part
cancer	cancer		NOUN-Number=Sing
candidate	candidate		NOUN-Number=Sing
candles	candle		NOUN-Number=Plur
capability	capability		NOUN-Number=Sing
capture	capture		VERB-VerbForm=Inf
caralluma	caralluma		NOUN-Number=Sing
car	car		NOUN-Number=Sing
card	card		NOUN-Number=Sing
cards	card		NOUN-Number=Plur
care	care		NOUN-Number=Sing
care	care		VERB-Mood=Ind|Tense=Pres|VerbForm=Fin
cared	care		VERB-Tense=Past|VerbForm=Part
careful	careful		ADJ-Degree=Pos
cargo	cargo		NOUN-Number=Sing
caricatures	caricature		NOUN-Number=Plur
carrier	carrier		NOUN-Number=Sing
carry	carry		VERB-Mood=Ind|Tense=Pres|VerbForm=Fin
cars	car		NOUN-Number=Plur
cartoon	cartoon		NOUN-Number=Sing
cartoonists	cartoonist		NOUN-Number=Plur
cartoons	cartoon		NOUN-Number=Plur
case	case		NOUN-Number=Sing
cases	case		NOUN-Number=Plur
cash	cash		NOUN-Number=Sing
casual	casual		NOUN-Number=Sing
cat	cat		NOUN-Number=Sing
catch	catch		VERB-VerbForm=Inf
category	category		NOUN-Number=Sing
caters	cater		VERB-Mood=Ind|Number=Sing|Person=3|Tense=Pres|VerbForm=Fin
cats	cat		NOUN-Number=Plur
caused	cause		VERB-Tense=Past|VerbForm=Part|Voice=Pass
causing	cause		VERB-VerbForm=Ger
cavity	cavity		NOUN-Number=Sing
&	&		CCONJ
cease	cease		NOUN-Number=Sing
cell	cell		NOUN-Number=Sing
cells	cell		NOUN-Number=Plur
center	center		NOUN-Number=Sing
central	central		ADJ-Degree=Pos
cents	cent		NOUN-Number=Plur
ceremony	ceremony		NOUN-Number=Sing
certain	certain		ADJ-Degree=Pos
certainly	certainly		ADV
certificate	certificate		NOUN-Number=Sing
certified	certify		VERB-Tense=Past|VerbForm=Part
chain	chain		NOUN-Number=Sing
chair	chair		NOUN-Number=Sing
chameleon	chameleon		NOUN-Number=Sing
chance	chance		NOUN-Number=Sing
change	change		VERB-VerbForm=Inf
changed	change		VERB-Mood=Ind|Tense=Past|VerbForm=Fin
changed	change		VERB-Tense=Past|VerbForm=Part
changed	change		VERB-Tense=Past|VerbForm=Part|Voice=Pass
changes	change		NOUN-Number=Plur
charge	charge		NOUN-Number=Sing
charge	charge		VERB-Mood=Ind|Tense=Pres|VerbForm=Fin
charge	charge		VERB-VerbForm=Inf
charged	charge		VERB-Tense=Past|VerbForm=Part
charging	charge		VERB-VerbForm=Ger
charity	charity		NOUN-Number=Sing
charming	charming		ADJ-Degree=Pos
chart	chart		NOUN-Number=Sing
charts	chart		NOUN-Number=Plur
chasing	chase		VERB-Tense=Pres|VerbForm=Part
cheap	cheap		ADJ-Degree=Pos
cheap	cheap		ADV
cheapest	cheapest		ADJ-Degree=Sup
cheaply	cheaply		ADV
check	check		NOUN-Number=Sing
check	check		VERB-Mood=Ind|Tense=Pres|VerbForm=Fin
check	check		VERB-VerbForm=Inf
checklists	checklist		NOUN-Number=Plur
cheep	cheep		ADJ-Degree=Pos
cheese	cheese		NOUN-Number=Sing
chemical	chemical		ADJ-Degree=Pos
chemises	chemise		NOUN-Number=Plur
chemistry	chemistry		NOUN-Number=Sing
chicken	chicken		NOUN-Number=Sing
chief	chief		ADJ-Degree=Pos
chihuahua	chihuahua		NOUN-Number=Sing
children	child		NOUN-Number=Plur
chips	chip		NOUN-Number=Plur
chitosan	chitosan		NOUN-Number=Sing
chocolate	chocolate		NOUN-Number=Sing
choice	choice		NOUN-Number=Sing
chorizo	chorizo		NOUN-Number=Sing
chromium	chromium		NOUN-Number=Sing
chronic	chronic		ADJ-Degree=Pos
chunk	chunk		NOUN-Number=Sing
church	church		NOUN-Number=Sing
cited	cite		VERB-Tense=Past|VerbForm=Part
cities	city		NOUN-Number=Plur
citizen	citizen		NOUN-Number=Sing
citizens	citizen		NOUN-Number=Plur
city	city		NOUN-Number=Sing
civil	civil		ADJ-Degree=Pos
civilians	civilian		NOUN-Number=Plur
claimed	claim		VERB-Mood=Ind|Tense=Past|VerbForm=Fin
claims	claim		NOUN-Number=Plur
clan	clan		NOUN-Number=Sing
clarify	clarify		VERB-Mood=Imp|VerbForm=Fin
clarify	clarify		VERB-VerbForm=Inf
clashed	clash		VERB-Mood=Ind|Tense=Past|VerbForm=Fin
clashes	clash		NOUN-Number=Plur
class	class		NOUN-Number=Sing
classical	classical		ADJ-Degree=Pos
clean	clean		ADJ-Degree=Pos
clean	clean		VERB-VerbForm=Inf
cleaned	clean		VERB-Tense=Past|VerbForm=Part
cleaner	cleaner		ADJ-Degree=Cmp
cleaning	clean		VERB-VerbForm=Ger
clear	clear		ADJ-Degree=Pos
clearly	clearly		ADV
cleric	cleric		NOUN-Number=Sing
clerics	cleric		NOUN-Number=Plur
click	click		NOUN-Number=Sing
client	client		NOUN-Number=Sing
clients	client		NOUN-Number=Plur
cliff	cliff		NOUN-Number=Sing
climbing	climb		VERB-VerbForm=Ger
close	close		ADJ-Degree=Pos
close	close		ADV-Degree=Pos
close	close		VERB-VerbForm=Inf
closed	closed		ADJ-Degree=Pos
closed	close		VERB-Mood=Ind|Tense=Past|VerbForm=Fin
closed	close		VERB-Tense=Past|VerbForm=Part
closely	closely		ADV
closer	closer		ADJ-Degree=Cmp
closer	closer		ADV-Degree=Cmp
closest	closest		ADJ-Degree=Sup
closing	close		VERB-VerbForm=Ger
cloth	cloth		NOUN-Number=Sing
clothes	clothes		NOUN-Number=Plur
clothing	clothing		NOUN-Number=Sing
clubbed	club		VERB-Tense=Past|VerbForm=Part|Voice=Pass
clubs	club		NOUN-Number=Plur
clues	clue		NOUN-Number=Plur
clutter	clutter		NOUN-Number=Sing
coagulated	coagulated		ADJ-Degree=Pos
coal	coal		NOUN-Number=Sing
coalition	coalition		NOUN-Number=Sing
cockatiel	cockatiel		NOUN-Number=Sing
cocker	cocker		NOUN-Number=Sing
code	code		NOUN-Number=Sing
coefficient	coefficient		NOUN-Number=Sing
coffee	coffee		NOUN-Number=Sing
coins	coin		NOUN-Number=Plur
cola	cola		NOUN-Number=Sing
cold	cold		ADJ-Degree=Pos
coleslaw	coleslaw		NOUN-Number=Sing
collapse	collapse		VERB-VerbForm=Inf
collect	collect		ADV
college	college		NOUN-Number=Sing
colonization	colonization		NOUN-Number=Sing
column	column		NOUN-Number=Sing
come	come		VERB-Mood=Imp|VerbForm=Fin
come	come		VERB-Mood=Ind|Tense=Pres|VerbForm=Fin
come	come		VERB-Tense=Past|VerbForm=Part
come	come		VERB-VerbForm=Inf
comes	come		VERB-Mood=Ind|Number=Sing|Person=3|Tense=Pres|VerbForm=Fin
coming	come		VERB-VerbForm=Ger
comment	comment		NOUN-Number=Sing
comment	comment		VERB-VerbForm=Inf
commented	comment		VERB-Mood=Ind|Tense=Past|VerbForm=Fin
comments	comment		NOUN-Number=Plur
commercial	commercial		ADJ-Degree=Pos
committed	committed		ADJ-Degree=Pos
committed	commit		VERB-Tense=Past|VerbForm=Part|Voice=Pass
commment	commment		NOUN-Number=Sing
common	common		ADJ-Degree=Pos
communicated	communicate		VERB-Tense=Past|VerbForm=Part
communication	communication		NOUN-Number=Sing
communications	communication		NOUN-Number=Plur
communicative	communicative		ADJ-Degree=Pos
communique	communique		NOUN-Number=Sing
community	community		NOUN-Number=Sing
compact	compact		ADJ-Degree=Pos
compaign	compaign		NOUN-Number=Sing
companie	companie		NOUN-Number=Sing
companies	company		NOUN-Number=Plur
companion	companion		NOUN-Number=Sing
company	company		NOUN-Number=Sing
comparable	comparable		ADJ-Degree=Pos
compared	compare		VERB-Tense=Past|VerbForm=Part
compiling	compile		VERB-VerbForm=Ger
complained	complain		VERB-Mood=Ind|Tense=Past|VerbForm=Fin
complaint	complaint		NOUN-Number=Sing
complaints	complaint		NOUN-Number=Plur
complete	complete		ADJ-Degree=Pos
complete	complete		VERB-Mood=Imp|VerbForm=Fin
completed	complete		VERB-Tense=Past|VerbForm=Part
completely	completely		ADV
completing	complete		VERB-VerbForm=Ger
complicated	complicated		ADJ-Degree=Pos
comply	comply		VERB-VerbForm=Inf
composed	compose		VERB-Tense=Past|VerbForm=Part|Voice=Pass
compromise	compromise		VERB-VerbForm=Inf
computer	computer		NOUN-Number=Sing
computers	computer		NOUN-Number=Plur
conceived	conceive		VERB-Tense=Past|VerbForm=Part
concern	concern		NOUN-Number=Sing
concerned	concerned		ADJ-Degree=Pos
concerning	concern		VERB-VerbForm=Ger
concerns	concern		NOUN-Number=Plur
condemned	condemn		VERB-Mood=Ind|Tense=Past|VerbForm=Fin
condition	condition		NOUN-Number=Sing
conducted	conduct		VERB-Tense=Past|VerbForm=Part
conference	conference		NOUN-Number=Sing
confessed	confess		VERB-Mood=Ind|Tense=Past|VerbForm=Fin
confidential	confidential		ADJ-Degree=Pos
confirm	confirm		VERB-VerbForm=Inf
confirmed	confirm		VERB-Tense=Past|VerbForm=Part
confirmed	confirm		VERB-Tense=Past|VerbForm=Part|Voice=Pass
conflict	conflict		NOUN-Number=Sing
conjunct	conjunct		ADJ-Degree=Pos
conjunction	conjunction		NOUN-Number=Sing
connect	connect		VERB-VerbForm=Inf
connection	connection		NOUN-Number=Sing
connections	connection		NOUN-Number=Plur
consequences	consequence		NOUN-Number=Plur
considerable	considerable		ADJ-Degree=Pos
consideration	consideration		NOUN-Number=Sing
consider	consider		VERB-VerbForm=Inf
considered	consider		VERB-Tense=Past|VerbForm=Part|Voice=Pass
considering	consider		VERB-VerbForm=Ger
consolidate	consolidate		VERB-VerbForm=Inf
construction	construction		NOUN-Number=Sing
consulted	consult		VERB-Tense=Past|VerbForm=Part
contactable	contactable		ADJ-Degree=Pos
contact	contact		NOUN-Number=Sing
contact	contact		VERB-Mood=Imp|VerbForm=Fin
contact	contact		VERB-VerbForm=Inf
contain	contain		VERB-VerbForm=Inf
contained	contain		VERB-Tense=Past|VerbForm=Part
containers	container		NOUN-Number=Plur
contaminated	contaminate		VERB-Tense=Past|VerbForm=Part|Voice=Pass
contemporary	contemporary		ADJ-Degree=Pos
contest	contest		NOUN-Number=Sing
context	context		NOUN-Number=Sing
contingents	contingent		NOUN-Number=Plur
continue	continue		VERB-Mood=Ind|Tense=Pres|VerbForm=Fin
continue	continue		VERB-VerbForm=Inf
continued	continue		VERB-Tense=Past|VerbForm=Part
continues	continue		VERB-Mood=Ind|Number=Sing|Person=3|Tense=Pres|VerbForm=Fin
contract	contract		NOUN-Number=Sing
contracts	contract		NOUN-Number=Plur
contribution	contribution		NOUN-Number=Sing
control	control		NOUN-Number=Sing
control	control		VERB-VerbForm=Inf
convenient	convenient		ADJ-Degree=Pos
conventional	conventional		ADJ-Degree=Pos
conversational	conversational		ADJ-Degree=Pos
conversation	conversation		NOUN-Number=Sing
converted	convert		VERB-Mood=Ind|Tense=Past|VerbForm=Fin
converting	convert		VERB-VerbForm=Ger
convictions	conviction		NOUN-Number=Plur
convinced	convince		VERB-Mood=Ind|Tense=Past|VerbForm=Fin
cooked	cook		VERB-Tense=Past|VerbForm=Part
cooking	cook		VERB-VerbForm=Ger
cool	cool		ADJ-Degree=Pos
copies	copy		NOUN-Number=Plur
copy	copy		NOUN-Number=Sing
copy	copy		VERB-Mood=Imp|VerbForm=Fin
copying	copying		NOUN-Number=Sing
cordobes	cordobes		NOUN-Number=Sing
cordon	cordon		NOUN-Number=Sing
corner	corner		NOUN-Number=Sing
corners	corner		NOUN-Number=Plur
corporate	corporate		ADJ-Degree=Pos
corporate	corporate		NOUN-Number=Sing
corporation	corporation		NOUN-Number=Sing
correct	correct		ADJ-Degree=Pos
corrections	correction		NOUN-Number=Plur
correctly	correctly		ADV
cos	cause		SCONJ-Abbr=Yes
cost	cost		NOUN-Number=Sing
costs	cost		NOUN-Number=Plur
cosy	cosy		ADJ-Degree=Pos
cottage	cottage		NOUN-Number=Sing
couch	couch		NOUN-Number=Sing
could	could		AUX-VerbForm=Fin
counter-attack	counter-attack		NOUN-Number=Sing
counterparty	counterparty		NOUN-Number=Sing
countries	country		NOUN-Number=Plur
country	country		NOUN-Number=Sing
couple	couple		ADJ-Degree=Pos
couple	couple		NOUN-Number=Sing
coupons	coupon		NOUN-Number=Plur
course	course		ADV
court	court		NOUN-Number=Sing
courteous	courteous		ADJ-Degree=Pos
courtroom	courtroom		NOUN-Number=Sing
courts	court		NOUN-Number=Plur
cousin	cousin		NOUN-Number=Sing
cousins	cousin		NOUN-Number=Plur
cover	cover		NOUN-Number=Sing
covert	covert		ADJ-Degree=Pos
coward	coward		NOUN-Number=Sing
cow	cow		NOUN-Number=Sing
cpa	cpa		NOUN-Number=Sing
cramped	cramped		ADJ-Degree=Pos
crap	crap		NOUN-Number=Sing
crappy	crappy		ADJ-Degree=Pos
crashed	crash		VERB-Mood=Ind|Tense=Past|VerbForm=Fin
crave	crave		VERB-Mood=Ind|Tense=Pres|VerbForm=Fin
crave	crave		VERB-VerbForm=Inf
cream	cream		NOUN-Number=Sing
create	create		VERB-Mood=Ind|Tense=Pres|VerbForm=Fin
created	create		VERB-Mood=Ind|Tense=Past|VerbForm=Fin
created	create		VERB-Tense=Past|VerbForm=Part
creates	create		VERB-Mood=Ind|Number=Sing|Person=3|Tense=Pres|VerbForm=Fin
creating	create		VERB-VerbForm=Ger
creative	creative		ADJ-Degree=Pos
credit	credit		NOUN-Number=Sing
creme	creme		ADJ-Degree=Pos
crew	crew		NOUN-Number=Sing
cried	cry		VERB-Mood=Ind|Tense=Past|VerbForm=Fin
crimes	crime		NOUN-Number=Plur
criminal	criminal		ADJ-Degree=Pos
criminal	criminal		ADJ-Number=Sing
critical	critical		ADJ-Degree=Pos
critic	critic		NOUN-Number=Sing
crops	crop		NOUN-Number=Plur
cross	cross		VERB-VerbForm=Inf
crossing	crossing		NOUN-Number=Sing
crossing	crossing		VERB-Number=Sing
crowd	crowd		NOUN-Number=Sing
crucial	crucial		ADJ-Degree=Pos
crude	crude		NOUN-Number=Sing
cruise	cruise		NOUN-Number=Sing
crush	crush		NOUN-Number=Sing
cubism	cubism		NOUN-Number=Sing
cues	cue		NOUN-Number=Plur
culture	culture		NOUN-Number=Sing
cup	cup		NOUN-Number=Sing
current	current		ADJ-Degree=Pos
currently	currently		ADV
curry	curry		NOUN-Number=Sing
customer	customer		NOUN-Number=Sing
customers	customer		NOUN-Number=Plur
cut	cut		NOUN-Number=Sing
cut	cut		VERB-Tense=Past|VerbForm=Part
cut	cut		VERB-Tense=Past|VerbForm=Part|Voice=Pass
cut	cut		VERB-VerbForm=Inf
cute	cute		ADJ-Degree=Pos
daily	daily		ADJ-Degree=Pos
damn	damn		ADV
danced	dance		VERB-Tense=Past|VerbForm=Part
dancing	dance		VERB-VerbForm=Ger
dangerous	dangerous		ADJ-Degree=Pos
dark	dark		ADJ-Degree=Pos
darn	darn		NOUN-Number=Sing
database	database		NOUN-Number=Sing
data	data		NOUN-Number=Sing
date	date		NOUN-Number=Sing
dated	date		VERB-Tense=Past|VerbForm=Part
dated	date		VERB-Tense=Past|VerbForm=Part|Voice=Pass
da	the		DET-Abbr=Yes
dating	date		VERB-VerbForm=Ger
daughter	daughter		NOUN-Number=Sing
day	day		NOUN-Number=Sing
days	day		NOUN-Number=Plur
d	due		ADP-Abbr=Yes
dead	dead		ADJ-Degree=Pos
deadly	deadly		ADV
deal	deal		NOUN-Number=Sing
deal	deal		VERB-VerbForm=Inf
dealer	dealer		NOUN-Number=Sing
dealing	dealing		NOUN-Number=Sing
dear	dear		ADJ-Degree=Pos
dear	dear		NOUN-Number=Sing
death	death		NOUN-Number=Sing
deaths	death		NOUN-Number=Plur
decade	decade		NOUN-Number=Sing
decent	decent		ADJ-Degree=Pos
decided	decide		VERB-Tense=Past|VerbForm=Part
decide	decide		VERB-VerbForm=Inf
decision	decision		NOUN-Number=Sing
decisions	decision		NOUN-Number=Plur
declared	declare		VERB-Mood=Ind|Tense=Past|VerbForm=Fin
declared	declare		VERB-Tense=Past|VerbForm=Part
defend	defend		VERB-VerbForm=Inf
defense	defense		NOUN-Number=Sing
deficit	deficit		NOUN-Number=Sing
definately	definately		ADV
definitely	definitely		ADV
delete	delete		VERB-Mood=Imp|VerbForm=Fin
delete	delete		VERB-VerbForm=Inf
delicious	delicious		ADJ-Degree=Pos
delightful	delightful		ADJ-Degree=Pos
delivered	deliver		VERB-Tense=Past|VerbForm=Part
delivery	delivery		NOUN-Number=Sing
demand	demand		NOUN-Number=Sing
demand	demand		VERB-Mood=Ind|Tense=Pres|VerbForm=Fin
demanded	demand		VERB-Tense=Past|VerbForm=Part
demanding	demand		VERB-Tense=Pres|VerbForm=Part
demonstration	demonstration		NOUN-Number=Sing
demonstrations	demonstration		NOUN-Number=Plur
demonstrators	demonstrator		NOUN-Number=Plur
denied	deny		VERB-Mood=Ind|Tense=Past|VerbForm=Fin
dental	dental		ADJ-Degree=Pos
dentist	dentist		NOUN-Number=Sing
deny	deny		VERB-VerbForm=Inf
department	department		NOUN-Number=Sing
depend	depend		VERB-VerbForm=Inf
depends	depend		VERB-Mood=Ind|Number=Sing|Person=3|Tense=Pres|VerbForm=Fin
depicting	depict		VERB-VerbForm=Ger
deploy	deploy		VERB-VerbForm=Inf
deposited	deposit		VERB-Tense=Past|VerbForm=Part
derail	derail		VERB-VerbForm=Inf
descendants	descendant		NOUN-Number=Plur
described	describe		VERB-Tense=Past|VerbForm=Part
describing	describe		VERB-Tense=Pres|VerbForm=Part
description	description		NOUN-Number=Sing
deserts	desert		NOUN-Number=Plur
deserved	deserve		VERB-Mood=Ind|Tense=Past|VerbForm=Fin
designated	designate		VERB-Tense=Past|VerbForm=Part
desk	desk		NOUN-Number=Sing
destroy	destroy		VERB-VerbForm=Inf
destruction	destruction		NOUN-Number=Sing
detail	detail		NOUN-Number=Sing
details	detail		NOUN-Number=Plur
determined	determined		ADJ-Degree=Pos
determine	determine		VERB-VerbForm=Inf
determines	determine		VERB-Mood=Ind|Number=Sing|Person=3|Tense=Pres|VerbForm=Fin
detonated	detonate		VERB-Mood=Ind|Tense=Past|VerbForm=Fin
devastated	devastate		VERB-Mood=Ind|Tense=Past|VerbForm=Fin
develop	develop		VERB-VerbForm=Inf
developed	develop		VERB-Mood=Ind|Tense=Past|VerbForm=Fin
developiong	developiong		VERB-VerbForm=Ger
development	development		NOUN-Number=Sing
devoted	devoted		ADJ-Degree=Pos
dial	dial		VERB-VerbForm=Inf
did	do		AUX-Mood=Ind|Tense=Past|VerbForm=Fin
did	do		VERB-Mood=Ind|Tense=Past|VerbForm=Fin
died	die		VERB-Mood=Ind|Tense=Past|VerbForm=Fin
die	die		VERB-VerbForm=Inf
dieters	dieter		NOUN-Number=Plur
differ	differ		VERB-VerbForm=Inf
differences	difference		NOUN-Number=Plur
different	different		ADJ-Degree=Pos
differential	differential		NOUN-Number=Sing
digging	dig		VERB-VerbForm=Ger
digic	digic		NOUN-Number=Sing
dilemmas	dilemma		NOUN-Number=Plur
dinner	dinner		NOUN-Number=Sing
direct	direct		ADJ-Degree=Pos
direction	direction		NOUN-Number=Sing
directly	directly		ADV
directors	director		NOUN-Number=Plur
directory	directory		NOUN-Number=Sing
dirty	dirty		ADJ-Degree=Pos
disability	disability		NOUN-Number=Sing
disappointed	disappoint		VERB-Tense=Past|VerbForm=Part
disappointed	disappoint		VERB-Tense=Past|VerbForm=Part|Voice=Pass
discount	discount		ADJ-Degree=Pos
discount	discount		NOUN-Number=Sing
discover	discover		VERB-VerbForm=Inf
discovered	discover		VERB-Tense=Past|VerbForm=Part
discretion	discretion		NOUN-Number=Sing
discriminated	discriminate		VERB-Mood=Ind|Tense=Past|VerbForm=Fin
discrimination	discrimination		NOUN-Number=Sing
discuss	discuss		VERB-VerbForm=Inf
discussed	discuss		VERB-Tense=Past|VerbForm=Part
discussing	discussing		ADJ-Degree=Pos
discussion	discussion		NOUN-Number=Sing
discussions	discussion		NOUN-Number=Plur
dishes	dish		NOUN-Number=Plur
dishonest	dishonest		ADJ-Degree=Pos
dislike	dislike		NOUN-Number=Sing
disorder	disorder		NOUN-Number=Sing
display	display		NOUN-Number=Sing
disrupt	disrupt		VERB-VerbForm=Inf
dissemination	dissemination		NOUN-Number=Sing
distance	distance		NOUN-Number=Sing
distribute	distribute		VERB-VerbForm=Inf
distributing	distribute		VERB-Tense=Pres|VerbForm=Part
distribution	distribution		NOUN-Number=Sing
district	district		NOUN-Number=Sing
diversity	diversity		NOUN-Number=Sing
doberman	doberman		NOUN-Number=Sing
.doc	.doc		NOUN-Number=Sing
doctor	doctor		NOUN-Number=Sing
document	document		NOUN-Number=Sing
dodgy	dodgy		ADJ-Degree=Pos
do	do		AUX-Mood=Imp|VerbForm=Fin
do	do		AUX-Mood=Ind|Tense=Pres|VerbForm=Fin
do	do		VERB-Mood=Imp|VerbForm=Fin
do	do		VERB-Mood=Ind|Tense=Pres|VerbForm=Fin
do	do		VERB-VerbForm=Inf
does	do		AUX-Mood=Ind|Number=Sing|Person=3|Tense=Pres|VerbForm=Fin
does	do		VERB-Mood=Ind|Number=Sing|Person=3|Tense=Pres|VerbForm=Fin
dog	dog		NOUN-Number=Sing
dogs	dog		NOUN-Number=Plur
doing	do		VERB-Tense=Pres|VerbForm=Part
doing	do		VERB-VerbForm=Ger
dollar	dollar		NOUN-Number=Sing
dollars	dollar		NOUN-Number=Plur
domain	domain		NOUN-Number=Sing
donated	donate		VERB-Tense=Past|VerbForm=Part
done	done		ADJ-Degree=Pos
done	do		VERB-Tense=Past|VerbForm=Part
done	do		VERB-Tense=Past|VerbForm=Part|Voice=Pass
door	door		NOUN-Number=Sing
double	double		ADJ-Degree=Pos
doubt	doubt		VERB-Mood=Ind|Tense=Pres|VerbForm=Fin
doubts	doubt		NOUN-Number=Plur
down	down		ADP
down	down		ADV
download	download		NOUN-Number=Sing
downloaded	download		VERB-Tense=Past|VerbForm=Part|Voice=Pass
downsize	downsize		VERB-VerbForm=Inf
downtown	downtown		NOUN-Number=Sing
draft	draft		NOUN-Number=Sing
drastically	drastically		ADV
dreams	dream		NOUN-Number=Plur
dress	dress		NOUN-Number=Sing
dressing	dress		VERB-VerbForm=Ger
drink	drink		NOUN-Number=Sing
drink	drink		VERB-Mood=Imp|VerbForm=Fin
drink	drink		VERB-VerbForm=Inf
drinks	drink		NOUN-Number=Plur
drive	drive		NOUN-Number=Sing
drive	drive		VERB-Mood=Ind|Tense=Pres|VerbForm=Fin
drive	drive		VERB-VerbForm=Inf
driven	drive		VERB-Tense=Past|VerbForm=Part
drop	drop		VERB-VerbForm=Inf
drove	drive		VERB-Mood=Ind|Tense=Past|VerbForm=Fin
druggy	druggy		NOUN-Number=Sing
dry	dry		ADJ-Degree=Pos
dual	dual		ADJ-Degree=Pos
dude	dude		NOUN-Number=Sing
du	do		AUX-Mood=Ind|Tense=Pres|VerbForm=Fin
due	due		ADP
dumpster	dumpster		NOUN-Number=Sing
dumpy	dumpy		ADJ-Degree=Pos
during	during		ADP
'd	would		AUX-VerbForm=Fin
d	would		AUX-VerbForm=Fin
each	each		DET
earlier	earlier		ADJ-Degree=Cmp
earlier	earlier		ADV-Degree=Cmp
early	early		ADJ-Degree=Pos
early	early		ADV-Degree=Pos
earnings	earnings		NOUN-Number=Plur
easiest	easiest		ADJ-Degree=Sup
easily	easily		ADV
east	east		ADJ-Degree=Pos
eastern	eastern		ADJ-Degree=Pos
easy	easy		ADJ-Degree=Pos
eat	eat		VERB-Mood=Ind|Tense=Pres|VerbForm=Fin
eat	eat		VERB-VerbForm=Inf
eating	eat		VERB-Tense=Pres|VerbForm=Part
echelons	echelon		NOUN-Number=Plur
e-commerce	e-commerce		NOUN-Number=Sing
economic	economic		ADJ-Degree=Pos
edge	edge		NOUN-Number=Sing
edges	edge		NOUN-Number=Plur
editor	editor		NOUN-Number=Sing
education	education		NOUN-Number=Sing
efax	efax		NOUN-Number=Sing
effective	effective		ADJ-Degree=Pos
efficient	efficient		ADJ-Degree=Pos
effort	effort		NOUN-Number=Sing
efforts	effort		NOUN-Number=Plur
egg	egg		NOUN-Number=Sing
egg	egg		VERB-Mood=Ind|Tense=Pres|VerbForm=Fin
eggs	egg		NOUN-Number=Plur
eh	eh		INTJ
either	either		CCONJ
elected	elect		VERB-Tense=Past|VerbForm=Part|Voice=Pass
election	election		NOUN-Number=Sing
elections	election		NOUN-Number=Plur
electrician	electrician		NOUN-Number=Sing
electricity	electricity		NOUN-Number=Sing
electronically	electronically		ADV
elementary	elementary		ADJ-Degree=Pos
elements	element		NOUN-Number=Plur
elevator	elevator		NOUN-Number=Sing
else	else		ADJ-Degree=Pos
else	else		ADV
e-mail	e-mail		NOUN-Number=Sing
email	email		NOUN-Number=Sing
e-mail	e-mail		VERB-VerbForm=Inf
email	email		VERB-VerbForm=Inf
embarrassed	embarrassed		ADJ-Degree=Pos
embarrassment	embarrassment		NOUN-Number=Sing
embroidered	embroider		VERB-Tense=Past|VerbForm=Part
embroidery	embroidery		NOUN-Number=Sing
emerge	emerge		VERB-VerbForm=Inf
emotional	emotional		ADJ-Degree=Pos
empanada	empanada		NOUN-Number=Sing
empanadas	empanada		NOUN-Number=Plur
employee	employee		NOUN-Number=Sing
employees	employee		NOUN-Number=Plur
emptiness	emptiness		NOUN-Number=Sing
enchiladas	enchilada		NOUN-Number=Plur
endeavors	endeavor		NOUN-Number=Plur
end	end		NOUN-Number=Sing
end	end		VERB-VerbForm=Inf
endowment	endowment		NOUN-Number=Sing
ends	end		NOUN-Number=Plur
energy	energy		NOUN-Number=Sing
enforcement	enforcement		NOUN-Number=Sing
engage	engage		VERB-Mood=Ind|Tense=Pres|VerbForm=Fin
engine	engine		NOUN-Number=Sing
engineer	engineer		NOUN-Number=Sing
enjoyed	enjoy		VERB-Mood=Ind|Tense=Past|VerbForm=Fin
enjoy	enjoy		VERB-Mood=Ind|Tense=Pres|VerbForm=Fin
enjoying	enjoy		VERB-Tense=Pres|VerbForm=Part
enlightened	enlightened		ADJ-Degree=Pos
enlighten	enlighten		VERB-VerbForm=Inf
enormous	enormous		ADJ-Degree=Pos
enough	enough		ADJ-Degree=Pos
enough	enough		ADV
enriched	enrich		VERB-Tense=Past|VerbForm=Part|Voice=Pass
ensuring	ensure		VERB-Tense=Pres|VerbForm=Part
entered	enter		VERB-Tense=Past|VerbForm=Part
enter	enter		VERB-VerbForm=Inf
entertainment	entertainment		NOUN-Number=Sing
enthusiast	enthusiast		NOUN-Number=Sing
enthusiasts	enthusiast		NOUN-Number=Plur
entire	entire		ADJ-Degree=Pos
entities	entity		NOUN-Number=Plur
entity	entity		NOUN-Number=Sing
environment	environment		NOUN-Number=Sing
equal	equal		ADJ-Degree=Pos
equals	equal		VERB-Mood=Ind|Number=Sing|Person=3|Tense=Pres|VerbForm=Fin
error	error		NOUN-Number=Sing
escalating	escalate		VERB-VerbForm=Ger
escalation	escalation		NOUN-Number=Sing
escaped	escape		VERB-Mood=Ind|Tense=Past|VerbForm=Fin
eschewing	eschew		VERB-VerbForm=Ger
especially	especially		ADV
essay	essay		NOUN-Number=Sing
essential	essential		ADJ-Degree=Pos
established	establish		VERB-Tense=Past|VerbForm=Part
esteem	esteem		NOUN-Number=Sing
est	est		VERB-Tense=Past|VerbForm=Part
estimated	estimate		VERB-Tense=Past|VerbForm=Part
estimated	estimate		VERB-Tense=Past|VerbForm=Part|Voice=Pass
estimate	estimate		VERB-VerbForm=Inf
evacuated	evacuate		VERB-Mood=Ind|Tense=Past|VerbForm=Fin
evacuates	evacuate		VERB-Mood=Ind|Number=Sing|Person=3|Tense=Pres|VerbForm=Fin
evacuating	evacuate		VERB-VerbForm=Ger
evacuation	evacuation		NOUN-Number=Sing
eva	eva		ADV
evaluate	evaluate		VERB-Mood=Ind|Tense=Pres|VerbForm=Fin
evaluating	evaluate		VERB-VerbForm=Ger
even	even		ADV
evening	evening		NOUN-Number=Sing
event	event		NOUN-Number=Sing
eventually	eventually		ADJ-Degree=Pos
ever	ever		ADV
every	every		DET
everyone	everyone		PRON-Number=Sing
everything	everything		PRON-Number=Sing
evidence	evidence		NOUN-Number=Sing
evil	evil		ADJ-Degree=Pos
ewww	ewww		INTJ
exactly	exactly		ADV
examined	examine		VERB-Mood=Ind|Tense=Past|VerbForm=Fin
example	example		NOUN-Number=Sing
examples	example		NOUN-Number=Plur
exceeded	exceed		VERB-Tense=Past|VerbForm=Part|Voice=Pass
excellent	excellent		ADJ-Degree=Pos
excelnt	excelnt		ADJ-Degree=Pos
except	except		ADP
exceptional	exceptional		ADJ-Degree=Pos
exception	exception		NOUN-Number=Sing
excerpt	excerpt		NOUN-Number=Sing
exchange	exchange		NOUN-Number=Sing
exciting	exciting		ADJ-Degree=Pos
excluded	exclude		VERB-Mood=Ind|Tense=Past|VerbForm=Fin
excluding	exclude		VERB-VerbForm=Ger
excuses	excuse		NOUN-Number=Plur
executed	execute		VERB-Tense=Past|VerbForm=Part
execute	execute		VERB-VerbForm=Inf
execution	execution		NOUN-Number=Sing
executive	executive		NOUN-Number=Sing
executives	executive		NOUN-Number=Plur
exit	exit		NOUN-Number=Sing
expectations	expectation		NOUN-Number=Plur
expected	expect		VERB-Tense=Past|VerbForm=Part
expect	expect		VERB-VerbForm=Inf
expecting	expect		VERB-Tense=Pres|VerbForm=Part
expecting	expect		VERB-VerbForm=Ger
expects	expect		VERB-Mood=Ind|Number=Sing|Person=3|Tense=Pres|VerbForm=Fin
expeditiously	expeditiously		ADV
expensive	expensive		ADJ-Degree=Pos
experienced	experienced		ADJ-Degree=Pos
experienced	experience		VERB-Tense=Past|VerbForm=Part
experience	experience		NOUN-Number=Sing
experiencing	experience		VERB-Tense=Pres|VerbForm=Part
experiments	experiment		NOUN-Number=Plur
expert	expert		NOUN-Number=Sing
explain	explain		VERB-VerbForm=Inf
exploration	exploration		NOUN-Number=Sing
explore	explore		VERB-VerbForm=Inf
expressed	express		VERB-Tense=Past|VerbForm=Part
expresses	express		VERB-Mood=Ind|Number=Sing|Person=3|Tense=Pres|VerbForm=Fin
expression	expression		NOUN-Number=Sing
extend	extend		VERB-VerbForm=Inf
ext.	ext.		NOUN-Number=Sing
extinction	extinction		NOUN-Number=Sing
extract	extract		NOUN-Number=Sing
extra	extra		ADJ-Degree=Pos
extraordinary	extraordinary		ADJ-Degree=Pos
extreme	extreme		ADJ-Degree=Pos
extremely	extremely		ADV
extrememly	extrememly		ADV
extremist	extremist		NOUN-Number=Sing
eyes	eye		NOUN-Number=Plur
f/2	f/2		NOUN-Number=Sing
fab	fab		ADJ-Degree=Pos
fabric	fabric		NOUN-Number=Sing
face	face		NOUN-Number=Sing
face	face		VERB-Mood=Ind|Tense=Pres|VerbForm=Fin
face	face		VERB-VerbForm=Inf
facilities	facility		NOUN-Number=Plur
facility	facility		NOUN-Number=Sing
fact	fact		NOUN-Number=Sing
facts	fact		NOUN-Number=Plur
failed	fail		VERB-Mood=Ind|Tense=Past|VerbForm=Fin
fair	fair		ADJ-Degree=Pos
fair	fair		NOUN-Number=Sing
fairly	fairly		ADV
fallacy	fallacy		NOUN-Number=Sing
fall	fall		VERB-VerbForm=Inf
family	family		NOUN-Number=Sing
famous	famous		ADJ-Degree=Pos
fanatic	fanatic		ADJ-Degree=Pos
fantastic	fantastic		ADJ-Degree=Pos
far	far		ADV-Degree=Pos
faster	faster		ADJ-Degree=Cmp
fast	fast		ADJ-Degree=Pos
fate	fate		NOUN-Number=Sing
fat	fat		ADJ-Degree=Pos
father	father		NOUN-Number=Sing
fave	fave		NOUN-Number=Sing
favor	favor		NOUN-Number=Sing
favorite	favorite		ADJ-Degree=Pos
favorite	favorite		NOUN-Number=Sing
faxed	fax		VERB-Mood=Ind|Tense=Past|VerbForm=Fin
feared	fear		VERB-Tense=Past|VerbForm=Part
fearing	fear		VERB-VerbForm=Ger
features	feature		NOUN-Number=Plur
feces	fece		NOUN-Number=Plur
federal	federal		ADJ-Degree=Pos
feedback	feedback		NOUN-Number=Sing
feed	feed		VERB-VerbForm=Inf
feel	feel		NOUN-Number=Sing
feel	feel		VERB-Mood=Imp|VerbForm=Fin
feel	feel		VERB-Mood=Ind|Tense=Pres|VerbForm=Fin
feel	feel		VERB-VerbForm=Inf
feeling	feeling		NOUN-Number=Sing
feelings	feeling		NOUN-Number=Plur
feels	feel		VERB-Mood=Ind|Number=Sing|Person=3|Tense=Pres|VerbForm=Fin
fees	fee		NOUN-Number=Plur
feet	foot		NOUN-Number=Plur
felt	feel		VERB-Mood=Ind|Tense=Past|VerbForm=Fin
female	female		ADJ-Degree=Pos
female	female		NOUN-Number=Sing
females	female		NOUN-Number=Plur
ferry	ferry		NOUN-Number=Sing
ferry	ferry		VERB-Mood=Ind|Tense=Pres|VerbForm=Fin
fertilized	fertilized		ADJ-Degree=Pos
fertilize	fertilize		VERB-VerbForm=Inf
fertilizer	fertilizer		NOUN-Number=Sing
festering	fester		VERB-VerbForm=Ger
fewest	fewest		ADJ-Degree=Sup
few	few		ADJ-Degree=Pos
f	f		NOUN-Number=Sing
fiction	fiction		NOUN-Number=Sing
field	field		NOUN-Number=Sing
fifth	fifth		ADV
fifth	fifth		NOUN-Number=Sing
fight	fight		NOUN-Number=Sing
fighting	fighting		NOUN-Number=Sing
fighting	fight		VERB-VerbForm=Ger
filed	file		VERB-Mood=Ind|Tense=Past|VerbForm=Fin
filed	file		VERB-Tense=Past|VerbForm=Part
file	file		NOUN-Number=Sing
files	file		NOUN-Number=Plur
filibuster	filibuster		NOUN-Number=Sing
filled	fill		VERB-Tense=Past|VerbForm=Part
filled	fill		VERB-Tense=Past|VerbForm=Part|Voice=Pass
fill	fill		VERB-VerbForm=Inf
filling	filling		ADJ-Degree=Pos
film	film		NOUN-Number=Sing
filters	filter		NOUN-Number=Plur
final	final		ADJ-Degree=Pos
finally	finally		ADV
finance	finance		NOUN-Number=Sing
financial	financial		ADJ-Degree=Pos
find	find		VERB-Mood=Imp|VerbForm=Fin
find	find		VERB-Mood=Ind|Tense=Pres|VerbForm=Fin
find	find		VERB-VerbForm=Inf
findin	findin		VERB-VerbForm=Ger
finding	find		VERB-VerbForm=Ger
finds	find		VERB-Mood=Ind|Number=Sing|Person=3|Tense=Pres|VerbForm=Fin
fined	fine		VERB-Tense=Past|VerbForm=Part|Voice=Pass
fine	fine		ADJ-Degree=Pos
fine	fine		ADV
fines	fine		NOUN-Number=Plur
finishes	finish		NOUN-Number=Plur
finishes	finish		VERB-Mood=Ind|Number=Sing|Person=3|Tense=Pres|VerbForm=Fin
fired	fire		VERB-Mood=Ind|Tense=Past|VerbForm=Fin
fired	fire		VERB-Tense=Past|VerbForm=Part
fire	fire		NOUN-Number=Sing
firing	fire		VERB-VerbForm=Ger
firm	firm		NOUN-Number=Sing
first	first		ADJ-Degree=Pos|NumType=Ord
first	first		ADV
first	first		NOUN-Number=Sing
fish	fish		NOUN-Number=Sing
fisrt	fisrt		ADJ-Degree=Pos
fit	fit		VERB-Mood=Ind|Tense=Pres|VerbForm=Fin
fit	fit		VERB-VerbForm=Inf
fixing	fix		VERB-VerbForm=Ger
flag	flag		NOUN-Number=Sing
flash	flash		NOUN-Number=Sing
flavored	flavored		ADJ-Degree=Pos
flawless	flawless		ADJ-Degree=Pos
fled	flee		VERB-Mood=Ind|Tense=Past|VerbForm=Fin
flew	fly		VERB-Mood=Ind|Tense=Past|VerbForm=Fin
flight	flight		NOUN-Number=Sing
flights	flight		NOUN-Number=Plur
floods	flood		NOUN-Number=Plur
florist	florist		NOUN-Number=Sing
flour	flour		NOUN-Number=Sing
flower	flower		NOUN-Number=Sing
flowers	flower		NOUN-Number=Plur
fly	fly		VERB-Mood=Ind|Tense=Pres|VerbForm=Fin
fly	fly		VERB-VerbForm=Inf
flying	fly		VERB-VerbForm=Ger
focus	focus		NOUN-Number=Sing
focus	focus		VERB-VerbForm=Inf
focusing	focus		VERB-VerbForm=Ger
f	of		ADP-Abbr=Yes
folks	folks		NOUN
followed	follow		VERB-Mood=Ind|Tense=Past|VerbForm=Fin
followed	follow		VERB-Tense=Past|VerbForm=Part
follow	follow		VERB-Mood=Imp|VerbForm=Fin
follow	follow		VERB-Mood=Ind|Tense=Pres|VerbForm=Fin
follow	follow		VERB-VerbForm=Inf
following	follow		VERB-Tense=Pres|VerbForm=Part
following	follow		VERB-VerbForm=Ger
food	food		NOUN-Number=Sing
foods	food		NOUN-Number=Plur
forces	force		NOUN-Number=Plur
foreigner	foreigner		NOUN-Number=Sing
foreigners	foreigner		NOUN-Number=Plur
foreign	foreign		ADJ-Degree=Pos
forensic	forensic		ADJ-Degree=Pos
forensic	forensic		NOUN-Number=Sing
for	for		ADP
for	for		ADV
for	for		SCONJ
forget	forget		VERB-Mood=Imp|VerbForm=Fin
forget	forget		VERB-VerbForm=Inf
forgive	forgive		VERB-VerbForm=Inf
forgot	forget		VERB-Mood=Ind|Tense=Past|VerbForm=Fin
formalizes	formalize		VERB-Mood=Ind|Number=Sing|Person=3|Tense=Pres|VerbForm=Fin
format	format		NOUN-Number=Sing
former	former		ADJ-Degree=Pos
form	form		NOUN-Number=Sing
forwarded	forward		VERB-Mood=Ind|Tense=Past|VerbForm=Fin
forwarded	forward		VERB-Tense=Past|VerbForm=Part
forwarded	forward		VERB-Tense=Past|VerbForm=Part|Voice=Pass
forward	forward		ADV
forward	forward		VERB-Mood=Imp|VerbForm=Fin
forward	forward		VERB-VerbForm=Inf
fought	fight		VERB-Mood=Ind|Tense=Past|VerbForm=Fin
fought	fight		VERB-Tense=Past|VerbForm=Part|Voice=Pass
fought	fight		VERB-VerbForm=Inf
foundation	foundation		NOUN-Number=Sing
founded	found		VERB-Mood=Ind|Tense=Past|VerbForm=Fin
founded	found		VERB-Tense=Past|VerbForm=Part
founded	found		VERB-Tense=Past|VerbForm=Part|Voice=Pass
found	find		VERB-Mood=Ind|Tense=Past|VerbForm=Fin
found	find		VERB-Tense=Past|VerbForm=Part
fourth	fourth		ADJ-Degree=Pos|NumType=Ord
foward	foward		ADV
fractional	fractional		ADJ-Degree=Pos
frame	frame		NOUN-Number=Sing
freak	freak		VERB-VerbForm=Inf
freedom	freedom		NOUN-Number=Sing
free	free		ADJ-Degree=Pos
freelance	freelance		ADJ-Degree=Pos
freely	freely		ADV
freewheeling	freewheeling		ADJ-Degree=Pos
french	french		ADJ-Degree=Pos
frequented	frequent		VERB-Tense=Past|VerbForm=Part|Voice=Pass
frequent	frequent		ADJ-Degree=Pos
frequently	frequently		ADV
fresh	fresh		ADJ-Degree=Pos
freshness	freshness		NOUN-Number=Sing
friend	friend		NOUN-Number=Sing
friendly	friendly		ADJ-Degree=Pos
friends	friend		NOUN-Number=Plur
friendship	friendship		NOUN-Number=Sing
fries	fries		NOUN-Number=Plur
from	from		ADP
from	from		SCONJ
front	front		ADV
front	front		NOUN-Number=Sing
frustrated	frustrated		ADJ-Degree=Pos
fucking	fuck		VERB-VerbForm=Ger
fulfill	fulfill		VERB-VerbForm=Inf
fulfillment	fulfillment		NOUN-Number=Sing
full	full		ADJ-Degree=Pos
fun	fun		ADJ-Degree=Pos
fun	fun		NOUN-Number=Sing
furnishing	furnishing		NOUN-Number=Sing
further	further		ADJ-Degree=Pos
further	further		ADV-Degree=Cmp
fussy	fussy		ADJ-Degree=Pos
future	future		ADJ-Degree=Pos
future	future		NOUN-Number=Sing
gaining	gain		VERB-VerbForm=Ger
gal	gal		NOUN-Number=Sing
gallery	gallery		NOUN-Number=Sing
game	game		NOUN-Number=Sing
games	game		NOUN-Number=Plur
garage	garage		NOUN-Number=Sing
garden	garden		NOUN-Number=Sing
garter	garter		NOUN-Number=Sing
gas	gas		NOUN-Number=Sing
gave	give		VERB-Mood=Ind|Tense=Past|VerbForm=Fin
gb	gb		NOUN-Number=Sing
geiven	geiven		VERB-Tense=Past|VerbForm=Part
gem	gem		NOUN-Number=Sing
general	general		ADJ-Degree=Pos
generate	generate		VERB-VerbForm=Inf
gentleman	gentleman		NOUN-Number=Sing
genuine	genuine		ADJ-Degree=Pos
gerbil	gerbil		NOUN-Number=Sing
german	german		ADJ-Degree=Pos
get	get		AUX-Mood=Imp|VerbForm=Fin
get	get		AUX-VerbForm=Inf
get	get		VERB-Mood=Imp|VerbForm=Fin
get	get		VERB-Mood=Ind|Tense=Pres|VerbForm=Fin
get	get		VERB-VerbForm=Inf
gets	get		VERB-Mood=Ind|Number=Sing|Person=3|Tense=Pres|VerbForm=Fin
getting	get		VERB-Tense=Pres|VerbForm=Part
getting	get		VERB-VerbForm=Ger
gf	gf		NOUN-Number=Sing
ghost	ghost		NOUN-Number=Sing
giant	giant		ADJ-Degree=Pos
gift	gift		NOUN-Number=Sing
gifts	gift		NOUN-Number=Plur
girl	girl		NOUN-Number=Sing
girls	girl		NOUN-Number=Plur
give	give		VERB-Mood=Imp|VerbForm=Fin
give	give		VERB-VerbForm=Inf
given	give		VERB-Tense=Past|VerbForm=Part
given	give		VERB-Tense=Past|VerbForm=Part|Voice=Pass
gives	give		VERB-Mood=Ind|Number=Sing|Person=3|Tense=Pres|VerbForm=Fin
giving	give		VERB-VerbForm=Ger
glad	glad		ADJ-Degree=Pos
gladly	gladly		ADV
glass	glass		NOUN-Number=Sing
global	global		ADJ-Degree=Pos
goal	goal		NOUN-Number=Sing
goals	goal		NOUN-Number=Plur
goat	goat		NOUN-Number=Sing
goes	go		VERB-Mood=Ind|Number=Sing|Person=3|Tense=Pres|VerbForm=Fin
go	go		VERB-Mood=Imp|VerbForm=Fin
go	go		VERB-Mood=Ind|Tense=Pres|VerbForm=Fin
go	go		VERB-VerbForm=Inf
going	go		VERB-Tense=Pres|VerbForm=Part
going	go		VERB-VerbForm=Ger
goin	goin		VERB-VerbForm=Ger
gold	gold		NOUN-Number=Sing
golf	golf		NOUN-Number=Sing
gone	gone		ADJ-Degree=Pos
gone	go		VERB-Tense=Past|VerbForm=Part
good	good		ADJ-Degree=Pos
good	good		NOUN-Number=Sing
google	google		VERB-Mood=Imp|VerbForm=Fin
googling	google		VERB-VerbForm=Ger
gorgeous	gorgeous		ADJ-Degree=Pos
got	get		AUX-Mood=Ind|Tense=Past|VerbForm=Fin
got	get		VERB-Mood=Ind|Tense=Past|VerbForm=Fin
got	get		VERB-Mood=Ind|Tense=Pres|VerbForm=Fin
got	get		VERB-Tense=Past|VerbForm=Part
got	get		VERB-Tense=Past|VerbForm=Part|Voice=Pass
gotten	get		VERB-Tense=Past|VerbForm=Part
governance	governance		NOUN-Number=Sing
government	government		NOUN-Number=Sing
governor	governor		NOUN-Number=Sing
grace	grace		NOUN-Number=Sing
grades	grade		NOUN-Number=Plur
grammar	grammar		NOUN-Number=Sing
grass	grass		NOUN-Number=Sing
grateful	grateful		ADJ-Degree=Pos
gratifying	gratifying		ADJ-Degree=Pos
greater	greater		ADJ-Degree=Cmp
great	great		ADJ-Degree=Pos
green	green		ADJ-Degree=Pos
grilled	grill		VERB-Tense=Past|VerbForm=Part
grooming	grooming		NOUN-Number=Sing
gross	gross		ADJ-Degree=Pos
group	group		NOUN-Number=Sing
groups	group		NOUN-Number=Plur
grow	grow		VERB-VerbForm=Inf
growing	grow		VERB-VerbForm=Ger
grown	grow		VERB-Tense=Past|VerbForm=Part
growth	growth		NOUN-Number=Sing
guality	guality		NOUN-Number=Sing
guaranteed	guarantee		VERB-Tense=Past|VerbForm=Part|Voice=Pass
guarantee	guarantee		NOUN-Number=Sing
guaranty	guaranty		NOUN-Number=Sing
guerrillas	guerrilla		NOUN-Number=Plur
guessed	guess		VERB-Tense=Past|VerbForm=Part|Voice=Pass
guess	guess		VERB-Mood=Ind|Tense=Pres|VerbForm=Fin
guessing	guess		VERB-VerbForm=Ger
guide	guide		NOUN-Number=Sing
gun	gun		NOUN-Number=Sing
guy	guy		NOUN-Number=Sing
guys	guy		NOUN-Number=Plur
habit	habit		NOUN-Number=Sing
had	have		AUX-Mood=Ind|Tense=Past|VerbForm=Fin
had	have		VERB-Mood=Ind|Tense=Past|VerbForm=Fin
had	have		VERB-Tense=Past|VerbForm=Part
hahaha	hahaha		INTJ
hairdresser	hairdresser		NOUN-Number=Sing
hair	hair		NOUN-Number=Sing
hairstyles	hairstyle		NOUN-Number=Plur
half	half		ADJ-Degree=Pos
hall	hall		NOUN-Number=Sing
hamburgers	hamburger		NOUN-Number=Plur
hamburguers	hamburguer		NOUN-Number=Plur
hamster	hamster		NOUN-Number=Sing
hamsters	hamster		NOUN-Number=Plur
hand	hand		NOUN-Number=Sing
handle	handle		VERB-VerbForm=Inf
hands	hand		NOUN-Number=Plur
happened	happen		VERB-Mood=Ind|Tense=Past|VerbForm=Fin
happen	happen		VERB-VerbForm=Inf
happens	happen		VERB-Mood=Ind|Number=Sing|Person=3|Tense=Pres|VerbForm=Fin
happy	happy		ADJ-Degree=Pos
hard	hard		ADJ-Degree=Pos
hard	hard		ADV-Degree=Pos
hardy	hardy		ADV
harmless	harmless		ADJ-Degree=Pos
harmonious	harmonious		ADJ-Degree=Pos
has	have		AUX-Mood=Ind|Number=Sing|Person=3|Tense=Pres|VerbForm=Fin
has	have		VERB
has	have		VERB-Mood=Ind|Number=Sing|Person=3|Tense=Pres|VerbForm=Fin
hassled	hassle		VERB-Tense=Past|VerbForm=Part
hassle	hassle		NOUN-Number=Sing
hatch	hatch		VERB-VerbForm=Inf
have	have		AUX-Mood=Ind|Tense=Pres|VerbForm=Fin
have	have		AUX-VerbForm=Inf
have	have		VERB-Mood=Imp|VerbForm=Fin
have	have		VERB-Mood=Ind|Tense=Pres|VerbForm=Fin
have	have		VERB-VerbForm=Inf
hav	have		VERB-Abbr=Yes|VerbForm=Inf
having	have		VERB-Tense=Pres|VerbForm=Part
having	have		VERB-VerbForm=Ger
ha[[y	ha[[y		ADJ-Degree=Pos
headed	head		VERB-Mood=Ind|Tense=Past|VerbForm=Fin
head	head		NOUN-Number=Sing
heading	head		VERB-VerbForm=Ger
heads	head		NOUN-Number=Plur
health	health		NOUN-Number=Sing
healthy	healthy		ADJ-Degree=Pos
heard	hear		VERB-Mood=Ind|Tense=Past|VerbForm=Fin
heard	hear		VERB-Tense=Past|VerbForm=Part
heard	hear		VERB-Tense=Past|VerbForm=Part|Voice=Pass
hear	hear		NOUN-Number=Sing
hear	hear		VERB-Mood=Ind|Tense=Pres|VerbForm=Fin
hear	hear		VERB-VerbForm=Inf
hearing	hear		VERB-VerbForm=Ger
heart	heart		NOUN-Number=Sing
heartland	heartland		NOUN-Number=Sing
heat	heat		VERB-VerbForm=Inf
heavily	heavily		ADV
heavy	heavy		ADJ-Degree=Pos
heels	heel		NOUN-Number=Plur
he	he		PRON-Case=Nom|Gender=Masc|Number=Sing|Person=3|PronType=Prs
height	height		NOUN-Number=Sing
heights	height		NOUN-Number=Plur
heirs	heir		NOUN-Number=Plur
helicopter	helicopter		NOUN-Number=Sing
helm	helm		NOUN-Number=Sing
helped	help		VERB-Mood=Ind|Tense=Past|VerbForm=Fin
helpful	helpful		ADJ-Degree=Pos
help	help		NOUN-Number=Sing
help	help		VERB-Mood=Imp|VerbForm=Fin
help	help		VERB-VerbForm=Inf
helping	help		VERB-VerbForm=Ger
helps	help		VERB-Mood=Ind|Number=Sing|Person=3|Tense=Pres|VerbForm=Fin
hence	hence		ADV
hereby	hereby		ADV
here	here		ADV-PronType=Dem
herein	herein		ADV
herself	herself		PRON-Case=Acc|Gender=Fem|Number=Sing|Person=3|PronType=Prs|Reflex=Yes
her	she		PRON-Case=Acc|Gender=Fem|Number=Sing|Person=3|PronType=Prs
her	she		PRON-Gender=Fem|Number=Sing|Person=3|Poss=Yes|PronType=Prs
hesitant	hesitant		ADJ-Degree=Pos
hesitate	hesitate		VERB-Mood=Imp|VerbForm=Fin
hesitate	hesitate		VERB-VerbForm=Inf
heures	heure		NOUN-Number=Plur
hidden	hidden		ADJ-Degree=Pos
higher	higher		ADJ-Degree=Cmp
higher	higher		ADV-Degree=Cmp
highest	highest		ADJ-Degree=Sup
high	high		ADJ-Degree=Pos
high	high		NOUN-Number=Sing
highly	highly		ADV
hill	hill		ADV
him	he		PRON-Case=Acc|Gender=Masc|Number=Sing|Person=3|PronType=Prs
himself	himself		PRON-Case=Acc|Gender=Masc|Number=Sing|Person=3|PronType=Prs|Reflex=Yes
hire	hire		NOUN-Number=Sing
hire	hire		VERB-VerbForm=Inf
hireing	hiree		VERB-VerbForm=Ger
his	he		PRON-Gender=Masc|Number=Sing|Person=3|Poss=Yes|PronType=Prs
historians	historian		NOUN-Number=Plur
historical	historical		ADJ-Degree=Pos
historic	historic		ADJ-Degree=Pos
history	history		NOUN-Number=Sing
hit	hit		NOUN-Number=Sing
hit	hit		VERB-Tense=Past|VerbForm=Part|Voice=Pass
hold	hold		VERB-VerbForm=Inf
holding	hold		VERB-Tense=Pres|VerbForm=Part
holding	hold		VERB-VerbForm=Ger
holidays	holiday		NOUN-Number=Plur
home	home		ADV
home	home		NOUN-Number=Sing
homeless	homeless		ADJ-Degree=Pos
homely	homely		ADJ-Degree=Pos
homestyle	homestyle		ADJ-Degree=Pos
honest	honest		ADJ-Degree=Pos
honest	honest		ADV
honeymoon	honeymoon		NOUN-Number=Sing
hoodia	hoodia		NOUN-Number=Sing
hoot	hoot		NOUN-Number=Sing
hopefully	hopefully		ADV
hope	hope		NOUN-Number=Sing
hope	hope		VERB-Mood=Imp|VerbForm=Fin
hope	hope		VERB-Mood=Ind|Tense=Pres|VerbForm=Fin
hopes	hope		VERB-Mood=Ind|Number=Sing|Person=3|Tense=Pres|VerbForm=Fin
hoping	hope		VERB-Tense=Pres|VerbForm=Part
hoping	hope		VERB-VerbForm=Ger
horrible	horrible		ADJ-Degree=Pos
horseman	horseman		NOUN-Number=Sing
horsemen	horseman		NOUN-Number=Plur
host	host		NOUN-Number=Sing
hostile	hostile		ADJ-Degree=Pos
hotdog	hotdog		NOUN-Number=Sing
hotdogs	hotdog		NOUN-Number=Plur
hotel	hotel		NOUN-Number=Sing
hot	hot		ADJ-Degree=Pos
hottest	hottest		ADJ-Degree=Sup
hour	hour		NOUN-Number=Sing
hourly	hourly		ADJ-Degree=Pos
hours	hour		NOUN-Number=Plur
house	house		NOUN-Number=Sing
house	house		VERB-Mood=Ind|Tense=Pres|VerbForm=Fin
housing	housing		NOUN-Number=Sing
hover	hover		NOUN-Number=Sing
however	however		ADV
how	how		ADV-PronType=Int
hrs	hr		NOUN-Number=Plur
huge	huge		ADJ-Degree=Pos
huh	huh		INTJ
human	human		ADJ-Degree=Pos
humans	human		NOUN-Number=Plur
hundreds	hundred		NOUN-Number=Plur
hurt	hurt		VERB-Tense=Past|VerbForm=Part|Voice=Pass
husband	husband		NOUN-Number=Sing
hymn	hymn		NOUN-Number=Sing
hype	hype		NOUN-Number=Sing
ible	ible		ADJ-Degree=Pos
ice	ice		NOUN-Number=Sing
idea	idea		NOUN-Number=Sing
ideas	idea		NOUN-Number=Plur
idiot	idiot		NOUN-Number=Sing
idiots	idiot		NOUN-Number=Plur
idk	idk		VERB-Mood=Ind|Tense=Pres|VerbForm=Fin
if	if		SCONJ
i	i		PRON-Case=Nom|Number=Sing|Person=1|PronType=Prs
illegal	illegal		ADJ-Degree=Pos
image	image		NOUN-Number=Sing
images	image		NOUN-Number=Plur
imagine	imagine		VERB-Mood=Ind|Tense=Pres|VerbForm=Fin
imagine	imagine		VERB-VerbForm=Inf
imaging	imaging		NOUN-Number=Sing
immediate	immediate		ADJ-Degree=Pos
immediately	immediately		ADV
impact	impact		NOUN-Number=Sing
implement	implement		VERB-VerbForm=Inf
implications	implication		NOUN-Number=Plur
important	important		ADJ-Degree=Pos
importantly	importantly		ADV
impose	impose		VERB-VerbForm=Inf
impossible	impossible		ADJ-Degree=Pos
impressed	impressed		ADJ-Degree=Pos
impressive	impressive		ADJ-Degree=Pos
imprisoned	imprison		VERB-Tense=Past|VerbForm=Part|Voice=Pass
imprisonment	imprisonment		NOUN-Number=Sing
improved	improve		VERB-Mood=Ind|Tense=Past|VerbForm=Fin
improve	improve		VERB-VerbForm=Inf
inability	inability		NOUN-Number=Sing
inaugural	inaugural		ADJ-Degree=Pos
incentive	incentive		NOUN-Number=Sing
incident	incident		NOUN-Number=Sing
incidents	incident		NOUN-Number=Plur
inclined	inclined		ADJ-Degree=Pos
include	include		VERB-Mood=Ind|Tense=Pres|VerbForm=Fin
includes	include		VERB-Mood=Ind|Number=Sing|Person=3|Tense=Pres|VerbForm=Fin
including	include		VERB-VerbForm=Ger
inclusive	inclusive		ADJ-Degree=Pos
income	income		NOUN-Number=Sing
incompetence	incompetence		NOUN-Number=Sing
inconvenience	inconvenience		NOUN-Number=Sing
incorporated	incorporate		VERB-Tense=Past|VerbForm=Part|Voice=Pass
incredibly	incredibly		ADV
indicated	indicate		VERB-Mood=Ind|Tense=Past|VerbForm=Fin
indicate	indicate		VERB-Mood=Ind|Tense=Pres|VerbForm=Fin
indication	indication		NOUN-Number=Sing
indie	indie		ADJ-Degree=Pos
individual	individual		NOUN-Number=Sing
individuals	individual		NOUN-Number=Plur
indoor	indoor		ADJ-Degree=Pos
industry	industry		NOUN-Number=Sing
ineffective	ineffective		ADJ-Degree=Pos
inefficient	inefficient		ADJ-Degree=Pos
inevitable	inevitable		ADJ-Degree=Pos
inexpensive	inexpensive		ADJ-Degree=Pos
infertile	infertile		ADJ-Degree=Pos
influenced	influence		VERB-Mood=Ind|Tense=Past|VerbForm=Fin
influencing	influence		VERB-VerbForm=Ger
influnced	influnce		VERB-Mood=Ind|Tense=Past|VerbForm=Fin
info	info		NOUN-Number=Sing
information	information		NOUN-Number=Sing
informed	informed		ADJ-Degree=Pos
informed	inform		VERB-Mood=Ind|Tense=Past|VerbForm=Fin
informed	inform		VERB-Tense=Past|VerbForm=Part|Voice=Pass
infrastructure	infrastructure		NOUN-Number=Sing
ingredients	ingredient		NOUN-Number=Plur
in	in		ADP
in	in		ADV
initial	initial		NOUN-Number=Sing
initially	initially		ADV
inputs	input		NOUN-Number=Plur
inquiry	inquiry		NOUN-Number=Sing
inside	inside		ADJ-Degree=Pos
inside	inside		ADP
ins	in		NOUN-Number=Plur
inspiring	inspiring		ADJ-Degree=Pos
installations	installation		NOUN-Number=Plur
installing	install		VERB-Tense=Pres|VerbForm=Part
instead	instead		ADV
instructed	instruct		VERB-Tense=Past|VerbForm=Part
instructed	instruct		VERB-Tense=Past|VerbForm=Part|Voice=Pass
instructors	instructor		NOUN-Number=Plur
instruments	instrument		NOUN-Number=Plur
insurance	insurance		NOUN-Number=Sing
insurgencies	insurgency		NOUN-Number=Plur
integrity	integrity		NOUN-Number=Sing
intelligence	intelligence		NOUN-Number=Sing
intended	intend		VERB-Tense=Past|VerbForm=Part
intended	intend		VERB-Tense=Past|VerbForm=Part|Voice=Pass
intend	intend		VERB-VerbForm=Inf
intends	intend		VERB-Mood=Ind|Number=Sing|Person=3|Tense=Pres|VerbForm=Fin
intensive	intensive		ADJ-Degree=Pos
intercept	intercept		NOUN-Number=Sing
interested	interested		ADJ-Degree=Pos
interesting	interesting		ADJ-Degree=Pos
interest	interest		NOUN-Number=Sing
interface	interface		NOUN-Number=Sing
interim	interim		ADJ-Degree=Pos
interior	interior		ADJ-Degree=Pos
international	international		ADJ-Degree=Pos
internet	internet		NOUN-Number=Sing
intern	intern		NOUN-Number=Sing
internship	internship		NOUN-Number=Sing
interpreted	interpret		VERB-Tense=Past|VerbForm=Part
interpret	interpret		VERB-VerbForm=Inf
interrogation	interrogation		NOUN-Number=Sing
intervals	interval		NOUN-Number=Plur
interview	interview		NOUN-Number=Sing
interview	interview		VERB-VerbForm=Inf
intimate	intimate		ADJ-Degree=Pos
into	into		ADP
intractable	intractable		ADJ-Degree=Pos
intrepid	intrepid		ADJ-Degree=Pos
introduced	introduce		VERB-Mood=Ind|Tense=Past|VerbForm=Fin
invest	invest		VERB-VerbForm=Inf
investors	investor		NOUN-Number=Plur
invite	invite		VERB-VerbForm=Inf
inviting	invite		VERB-VerbForm=Ger
involved	involved		ADJ-Degree=Pos
involvement	involvement		NOUN-Number=Sing
involving	involve		VERB-VerbForm=Ger
iphone	iphone		NOUN-Number=Sing
iPhone	iphone		NOUN-Number=Sing
irc	irc		NOUN-Number=Sing
ire	ire		NOUN-Number=Sing
irish	irish		ADJ-Degree=Pos
is	be		AUX-Mood=Ind|Number=Sing|Person=3|Tense=Pres|VerbForm=Fin
is	be		VERB-Mood=Ind|Number=Sing|Person=3|Tense=Pres|VerbForm=Fin
islad	islad		NOUN-Number=Sing
island	island		NOUN-Number=Sing
islands	island		NOUN-Number=Plur
issued	issue		VERB-Mood=Ind|Tense=Past|VerbForm=Fin
issued	issue		VERB-Tense=Past|VerbForm=Part|Voice=Pass
issue	issue		NOUN-Number=Sing
issues	issue		NOUN-Number=Plur
issuing	issue		VERB-VerbForm=Ger
item	item		NOUN-Number=Sing
items	item		NOUN-Number=Plur
it	it		PRON-Case=Acc|Gender=Neut|Number=Sing|Person=3|PronType=Prs
it	it		PRON-Case=Nom|Gender=Neut|Number=Sing|Person=3|PronType=Prs
itself	itself		PRON-Case=Acc|Gender=Neut|Number=Sing|Person=3|PronType=Prs|Reflex=Yes
itself	itself		PRON-Gender=Neut|Number=Sing|Person=3|PronType=Prs
it's	it's		PRON
its	its		PRON-Gender=Neut|Number=Sing|Person=3|Poss=Yes|PronType=Prs
jacket	jacket		NOUN-Number=Sing
japanese	japanese		ADJ-Degree=Pos
jihad	jihad		NOUN-Number=Sing
job	job		NOUN-Number=Sing
joe	joe		NOUN-Number=Sing
joined	join		VERB-Mood=Ind|Tense=Past|VerbForm=Fin
joined	join		VERB-Tense=Past|VerbForm=Part
join	join		VERB-Mood=Imp|VerbForm=Fin
journalist	journalist		NOUN-Number=Sing
joy	joy		NOUN-Number=Sing
judge	judge		NOUN-Number=Sing
judges	judge		NOUN-Number=Plur
juicy	juicy		ADJ-Degree=Pos
jump	jump		VERB-VerbForm=Inf
jungle	jungle		NOUN-Number=Sing
jurists	jurist		NOUN-Number=Plur
justify	justify		VERB-VerbForm=Inf
just	just		ADV
keep	keep		VERB-Mood=Imp|VerbForm=Fin
keep	keep		VERB-Mood=Ind|Tense=Pres|VerbForm=Fin
keep	keep		VERB-VerbForm=Inf
keeps	keep		VERB-Mood=Ind|Number=Sing|Person=3|Tense=Pres|VerbForm=Fin
kept	keep		VERB-Mood=Ind|Tense=Past|VerbForm=Fin
kept	keep		VERB-Tense=Past|VerbForm=Part
keying	key		VERB-VerbForm=Ger
key	key		ADJ-Degree=Pos
kicked	kick		VERB-Tense=Past|VerbForm=Part
kick	kick		VERB-VerbForm=Inf
kidding	kid		VERB-Tense=Pres|VerbForm=Part
kidding	kid		VERB-VerbForm=Ger
kidnapping	kidnapping		NOUN-Number=Sing
kidney	kidney		NOUN-Number=Sing
kids	kid		NOUN-Number=Plur
killed	kill		VERB-Mood=Ind|Tense=Past|VerbForm=Fin
killed	kill		VERB-Tense=Past|VerbForm=Part
killed	kill		VERB-Tense=Past|VerbForm=Part|Voice=Pass
killing	kill		VERB-VerbForm=Ger
kill	kill		VERB-VerbForm=Inf
kilometers	kilometer		NOUN-Number=Plur
kinda	kinda		ADV
kind	kind		ADJ-Degree=Pos
kind	kind		ADV
kind	kind		NOUN-Number=Sing
kitten	kitten		NOUN-Number=Sing
kittens	kitten		NOUN-Number=Plur
km	km		NOUN-Number=Plur
knew	know		VERB-Mood=Ind|Tense=Past|VerbForm=Fin
knocks	knock		VERB-Mood=Ind|Number=Sing|Person=3|Tense=Pres|VerbForm=Fin
know	know		ADV
know	know		VERB-Mood=Ind|Tense=Pres|VerbForm=Fin
know	know		VERB-VerbForm=Inf
knowledgable	knowledgable		ADJ-Degree=Pos
knowledgeable	knowledgeable		ADJ-Degree=Pos
knowledge	knowledge		NOUN-Number=Sing
knowledgement	knowledgement		NOUN-Number=Sing
known	know		VERB-Tense=Past|VerbForm=Part
knows	know		VERB-Mood=Ind|Number=Sing|Person=3|Tense=Pres|VerbForm=Fin
knuckle	knuckle		NOUN-Number=Sing
lab	lab		NOUN-Number=Sing
lacking	lack		VERB-Tense=Pres|VerbForm=Part
lack	lack		NOUN-Number=Sing
laden	laden		ADJ-Degree=Pos
laid	lay		VERB-Mood=Ind|Tense=Past|VerbForm=Fin
landed	land		VERB-Tense=Past|VerbForm=Part
land	land		NOUN-Number=Sing
language	language		NOUN-Number=Sing
laptop	laptop		NOUN-Number=Sing
laptops	laptop		NOUN-Number=Plur
large	large		ADJ-Degree=Pos
largely	largely		ADV
larger	larger		ADJ-Degree=Cmp
lashing	lash		VERB-VerbForm=Ger
last	last		ADJ-Degree=Pos
last	last		VERB-Mood=Ind|Tense=Pres|VerbForm=Fin
late	late		ADJ-Degree=Pos
late	late		ADV-Degree=Pos
later	later		ADV
later	later		ADV-Degree=Cmp
laudatory	laudatory		ADJ-Degree=Pos
launched	launch		VERB-Mood=Ind|Tense=Past|VerbForm=Fin
launched	launch		VERB-Tense=Past|VerbForm=Part
launch	launch		NOUN-Number=Sing
launch	launch		VERB-VerbForm=Inf
law	law		NOUN-Number=Sing
lawsuit	lawsuit		NOUN-Number=Sing
lawyer	lawyer		NOUN-Number=Sing
laying	lay		VERB-VerbForm=Ger
lay	lay		VERB-VerbForm=Inf
leader	leader		NOUN-Number=Sing
leadership	leadership		NOUN-Number=Sing
leaders	leader		NOUN-Number=Plur
leading	lead		VERB-VerbForm=Ger
lead	lead		ADJ-Degree=Pos
leads	lead		VERB-Mood=Ind|Number=Sing|Person=3|Tense=Pres|VerbForm=Fin
learned	learn		VERB-Mood=Ind|Tense=Past|VerbForm=Fin
learning	learning		NOUN-Number=Sing
learning	learn		VERB-VerbForm=Ger
least	least		ADV-Degree=Sup
leave	leave		VERB-VerbForm=Inf
leaves	leave		VERB-Mood=Ind|Number=Sing|Person=3|Tense=Pres|VerbForm=Fin
leaving	leave		VERB-VerbForm=Ger
left	leave		VERB-Mood=Ind|Tense=Past|VerbForm=Fin
left	leave		VERB-Tense=Past|VerbForm=Part
left	leave		VERB-Tense=Past|VerbForm=Part|Voice=Pass
legacy	legacy		NOUN-Number=Sing
legnth	legnth		NOUN-Number=Sing
lenght	lenght		NOUN-Number=Sing
lengthy	lengthy		ADJ-Degree=Pos
lens	lens		NOUN-Number=Sing
less	less		ADJ-Degree=Cmp
less	less		ADV-Degree=Cmp
lesson	lesson		NOUN-Number=Sing
lessons	lesson		NOUN-Number=Plur
let	let		VERB-Mood=Imp|VerbForm=Fin
let	let		VERB-Mood=Ind|Tense=Past|VerbForm=Fin
let	let		VERB-VerbForm=Inf
let's	let'		VERB-Mood=Ind|Number=Sing|Person=3|Tense=Pres|VerbForm=Fin
letter	letter		NOUN-Number=Sing
level	level		NOUN-Number=Sing
level	level		VERB-Mood=Ind|Tense=Pres|VerbForm=Fin
liberal	liberal		ADJ-Degree=Pos
libido	libido		NOUN-Number=Sing
library	library		ADJ-Degree=Pos
library	library		NOUN-Number=Sing
liens	lien		NOUN-Number=Plur
lies	lie		VERB-Mood=Ind|Number=Sing|Person=3|Tense=Pres|VerbForm=Fin
life	life		NOUN-Number=Sing
lifestyle	lifestyle		NOUN-Number=Sing
light	light		ADJ-Degree=Pos
light	light		NOUN-Number=Sing
lightning	lightning		NOUN-Number=Sing
lights	light		NOUN-Number=Plur
likelihood	likelihood		NOUN-Number=Sing
like	like		ADP
like	like		INTJ
like	like		SCONJ
like	like		VERB-Mood=Ind|Tense=Pres|VerbForm=Fin
like	like		VERB-VerbForm=Inf
likely	likely		ADJ-Degree=Pos
likely	likely		ADV
limitations	limitation		NOUN-Number=Plur
limited	limited		ADJ-Degree=Pos
limits	limit		NOUN-Number=Plur
line	line		NOUN-Number=Sing
lines	line		NOUN-Number=Plur
lingerie	lingerie		NOUN-Number=Sing
linked	link		VERB-Tense=Past|VerbForm=Part
link	link		NOUN-Number=Sing
links	link		NOUN-Number=Plur
listed	list		VERB-Mood=Ind|Tense=Past|VerbForm=Fin
listens	listen		VERB-Mood=Ind|Number=Sing|Person=3|Tense=Pres|VerbForm=Fin
listing	listing		NOUN-Number=Sing
list	list		NOUN-Number=Sing
lists	list		NOUN-Number=Plur
litter	litter		NOUN-Number=Sing
little	little		ADJ-Degree=Pos
live	live		ADJ-Degree=Pos
live	live		ADV
live	live		VERB-Mood=Ind|Tense=Pres|VerbForm=Fin
lives	life		NOUN-Number=Plur
lives	live		VERB-Mood=Ind|Number=Sing|Person=3|Tense=Pres|VerbForm=Fin
living	live		VERB-VerbForm=Ger
living	living		NOUN-Number=Sing
'll	will		AUX-VerbForm=Fin
ll	will		AUX-VerbForm=Fin
load	load		VERB-VerbForm=Inf
loan	loan		NOUN-Number=Sing
loathe	loathe		ADJ-Degree=Pos
local	local		ADJ-Degree=Pos
located	locate		VERB-Tense=Past|VerbForm=Part
located	locate		VERB-Tense=Past|VerbForm=Part|Voice=Pass
location	location		NOUN-Number=Sing
locked	lock		VERB-Tense=Past|VerbForm=Part
logical	logical		ADJ-Degree=Pos
lol	lol		INTJ
lols	lols		INTJ
longer	longer		ADV-Degree=Cmp
long	long		ADJ-Degree=Pos
long	long		ADV-Degree=Pos
longtime	longtime		ADV
looked	look		VERB-Mood=Ind|Tense=Past|VerbForm=Fin
looking	look		VERB-Tense=Pres|VerbForm=Part
looking	look		VERB-VerbForm=Ger
look	look		NOUN-Number=Sing
look	look		VERB-Mood=Imp|VerbForm=Fin
look	look		VERB-Mood=Ind|Tense=Pres|VerbForm=Fin
look	look		VERB-VerbForm=Inf
looks	look		VERB-Mood=Ind|Number=Sing|Person=3|Tense=Pres|VerbForm=Fin
loose	loose		ADJ-Degree=Pos
losing	lose		VERB-VerbForm=Ger
loss	loss		NOUN-Number=Sing
lost	lose		VERB-Mood=Ind|Tense=Past|VerbForm=Fin
lost	lose		VERB-Tense=Past|VerbForm=Part
lost	lost		ADJ-Degree=Pos
lot	lot		NOUN-Number=Sing
lots	lot		NOUN-Number=Plur
lounge	lounge		NOUN-Number=Sing
lounges	lounge		NOUN-Number=Plur
loved	love		VERB-Mood=Ind|Tense=Past|VerbForm=Fin
love	love		NOUN-Number=Sing
love	love		VERB-Mood=Ind|Tense=Pres|VerbForm=Fin
lovely	lovely		ADJ-Degree=Pos
loves	love		VERB-Mood=Ind|Number=Sing|Person=3|Tense=Pres|VerbForm=Fin
loving	loving		ADJ-Degree=Pos
lovin	lovin		NOUN-Number=Sing
lower	lower		ADJ-Degree=Cmp
lowest	lowest		ADJ-Degree=Sup
low	low		ADJ-Degree=Pos
loyal	loyal		ADJ-Degree=Pos
luck	luck		NOUN-Number=Sing
lucky	lucky		ADJ-Degree=Pos
luggage	luggage		NOUN-Number=Sing
luggages	luggage		NOUN-Number=Plur
lunch	lunch		NOUN-Number=Sing
lurking	lurking		NOUN-Number=Sing
luxurious	luxurious		ADJ-Degree=Pos
lying	lie		VERB-VerbForm=Ger
lynx	lynx		NOUN-Number=Sing
macho	macho		NOUN-Number=Sing
made	make		VERB-Mood=Ind|Tense=Past|VerbForm=Fin
made	make		VERB-Tense=Past|VerbForm=Part
made	make		VERB-Tense=Past|VerbForm=Part|Voice=Pass
magazine	magazine		NOUN-Number=Sing
mailed	mail		VERB-Tense=Past|VerbForm=Part
mail	mail		NOUN-Number=Sing
maime	maime		VERB-VerbForm=Inf
main	main		ADJ-Degree=Pos
major	major		ADJ-Degree=Pos
make	make		VERB-Mood=Imp|VerbForm=Fin
make	make		VERB-Mood=Ind|Tense=Pres|VerbForm=Fin
make	make		VERB-VerbForm=Inf
maker	maker		NOUN-Number=Sing
makers	maker		NOUN-Number=Plur
makes	make		VERB-Mood=Ind|Number=Sing|Person=3|Tense=Pres|VerbForm=Fin
making	make		VERB-Tense=Pres|VerbForm=Part
making	make		VERB-VerbForm=Ger
making	making		NOUN-Number=Sing
male	male		ADJ-Degree=Pos
male	male		NOUN-Number=Sing
males	male		NOUN-Number=Plur
mall	mall		NOUN-Number=Sing
management	management		NOUN-Number=Sing
mane	mane		NOUN-Number=Sing
manhunt	manhunt		NOUN-Number=Sing
mani	mani		NOUN-Number=Sing
man	man		NOUN-Number=Sing
many	many		ADJ-Degree=Pos
market	market		NOUN-Number=Sing
markets	market		NOUN-Number=Plur
mark	mark		VERB-VerbForm=Inf
married	marry		VERB-Tense=Past|VerbForm=Part|Voice=Pass
masses	mass		NOUN-Number=Plur
massive	massive		ADJ-Degree=Pos
mass	mass		ADJ-Degree=Pos
master	master		NOUN-Number=Sing
mated	mate		VERB-Mood=Ind|Tense=Past|VerbForm=Fin
material	material		ADJ-Degree=Pos
material	material		NOUN-Number=Sing
materials	material		NOUN-Number=Plur
mathematical	mathematical		ADJ-Degree=Pos
matter	matter		ADV
matter	matter		NOUN-Number=Sing
matter	matter		VERB-VerbForm=Inf
maybe	maybe		ADV
may	may		AUX-VerbForm=Fin
mayonnaise	mayonnaise		NOUN-Number=Sing
'm	be		AUX-Mood=Ind|Tense=Pres|VerbForm=Fin
m	be		AUX-Mood=Ind|Tense=Pres|VerbForm=Fin
meal	meal		NOUN-Number=Sing
meals	meal		NOUN-Number=Plur
meaning	meaning		NOUN-Number=Sing
mean	mean		ADJ-Degree=Pos
mean	mean		NOUN-Number=Sing
mean	mean		VERB-Mood=Ind|Tense=Pres|VerbForm=Fin
mean	mean		VERB-VerbForm=Inf
means	mean		VERB-Mood=Ind|Number=Sing|Person=3|Tense=Pres|VerbForm=Fin
meant	mean		VERB-Mood=Ind|Tense=Past|VerbForm=Fin
meat	meat		NOUN-Number=Sing
mechanic	mechanic		NOUN-Number=Sing
media	media		NOUN-Number=Sing
mediocre	mediocre		ADJ-Degree=Pos
meeting	meeting		NOUN-Number=Sing
meeting	meet		VERB-VerbForm=Ger
meet	meet		VERB-VerbForm=Inf
meets	meet		VERB-Mood=Ind|Number=Sing|Person=3|Tense=Pres|VerbForm=Fin
meh	meh		ADJ-Degree=Pos
me	I		PRON-Case=Acc|Number=Sing|Person=1|PronType=Prs
member	member		NOUN-Number=Sing
members	member		NOUN-Number=Plur
memoir	memoir		NOUN-Number=Sing
memoirs	memoirs		NOUN-Number=Plur
memorabilia	memorabilia		NOUN-Number=Sing
memorial	memorial		NOUN-Number=Sing
men	man		NOUN-Number=Plur
mentioned	mention		VERB-Mood=Ind|Tense=Past|VerbForm=Fin
mentioned	mention		VERB-Tense=Past|VerbForm=Part
mention	mention		VERB-Mood=Ind|Tense=Pres|VerbForm=Fin
menu	menu		NOUN-Number=Sing
mesmerizing	mesmerizing		ADJ-Degree=Pos
message	message		NOUN-Number=Sing
mess	mess		NOUN-Number=Sing
metal	metal		NOUN-Number=Sing
methodology	methodology		NOUN-Number=Sing
met	meet		VERB-Mood=Ind|Tense=Past|VerbForm=Fin
met	meet		VERB-Tense=Past|VerbForm=Part
mexican	mexican		ADJ-Degree=Pos
middle	middle		NOUN-Number=Sing
midnight	midnight		NOUN-Number=Sing
might	might		AUX-VerbForm=Fin
mighty	mighty		ADJ-Degree=Pos
migratory	migratory		ADJ-Degree=Pos
miles	mile		NOUN-Number=Plur
militant	militant		ADJ-Degree=Pos
military	military		ADJ-Degree=Pos
military	military		NOUN-Number=Sing
militias	militia		NOUN-Number=Plur
millions	million		NOUN-Number=Plur
mimicking	mimic		VERB-VerbForm=Ger
minded	minded		ADJ-Degree=Pos
mind	mind		NOUN-Number=Sing
mind	mind		VERB-VerbForm=Inf
mine	mine		PRON
miniscule	miniscule		ADJ-Degree=Pos
mins	min		NOUN-Number=Plur
minute	minute		NOUN-Number=Sing
minutes	minute		NOUN-Number=Plur
mired	mire		VERB-Tense=Past|VerbForm=Part
mismanaged	mismanage		VERB-Mood=Ind|Tense=Past|VerbForm=Fin
mis-matches	mis-match		NOUN-Number=Plur
missile	missile		NOUN-Number=Sing
missing	missing		ADJ-Degree=Pos
missing	miss		VERB-Tense=Pres|VerbForm=Part
miss	miss		NOUN-Number=Sing
miss	miss		VERB-VerbForm=Inf
mistake	mistake		NOUN-Number=Sing
mistakes	mistake		NOUN-Number=Plur
mm	mm		NOUN-Number=Plur
modelling	model		VERB-Tense=Pres|VerbForm=Part
model	model		NOUN-Number=Sing
mode	mode		NOUN-Number=Sing
modern	modern		ADJ-Degree=Pos
mold	mold		NOUN-Number=Sing
moment	moment		NOUN-Number=Sing
money	money		NOUN-Number=Sing
monthly	monthly		ADJ-Degree=Pos
monthly	monthly		ADV
month	month		NOUN-Number=Sing
months	month		NOUN-Number=Plur
mopping	mop		VERB-VerbForm=Ger
morcillas	morcilla		NOUN-Number=Plur
more	more		ADJ-Degree=Cmp
more	more		ADV
morning	morning		NOUN-Number=Sing
most	most		ADJ-Degree=Sup
most	most		ADV
motherboard	motherboard		NOUN-Number=Sing
mother	mother		NOUN-Number=Sing
motive	motive		NOUN-Number=Sing
motives	motive		NOUN-Number=Plur
mould	mould		NOUN-Number=Sing
mountain	mountain		NOUN-Number=Sing
mounted	mount		VERB-Mood=Ind|Tense=Past|VerbForm=Fin
mouse	mouse		NOUN-Number=Sing
mouths	mouth		NOUN-Number=Plur
moved	move		VERB-Mood=Ind|Tense=Past|VerbForm=Fin
moved	move		VERB-Tense=Past|VerbForm=Part
movement	movement		NOUN-Number=Sing
move	move		NOUN-Number=Sing
move	move		VERB-VerbForm=Inf
movie	movie		NOUN-Number=Sing
movies	movie		NOUN-Number=Plur
moving	move		VERB-Tense=Pres|VerbForm=Part
moving	move		VERB-VerbForm=Ger
moving	moving		NOUN-Number=Sing
much	much		ADJ-Degree=Pos
much	much		ADV
multiple	multiple		ADJ-Degree=Pos
murder	murder		NOUN-Number=Sing
musems	musem		NOUN-Number=Plur
museum	museum		NOUN-Number=Sing
music	music		NOUN-Number=Sing
must	must		AUX-VerbForm=Fin
must	must		NOUN-Number=Sing
mutual	mutual		ADJ-Degree=Pos
my	my		PRON-Number=Sing|Person=1|Poss=Yes|PronType=Prs
myself	myself		PRON-Case=Acc|Number=Sing|Person=1|PronType=Prs|Reflex=Yes
mythical	mythical		ADJ-Degree=Pos
naborhood	neighborhood		NOUN-Number=Sing
nail	nail		NOUN-Number=Sing
named	name		VERB-Tense=Past|VerbForm=Part
named	name		VERB-Tense=Past|VerbForm=Part|Voice=Pass
name	name		NOUN-Number=Sing
name	name		VERB-Tense=Past|VerbForm=Part
name	name		VERB-VerbForm=Inf
names	name		NOUN-Number=Plur
naming	name		VERB-VerbForm=Ger
n	and		CCONJ-Abbr=Yes
napkin	napkin		NOUN-Number=Sing
natal	natal		ADJ-Degree=Pos
nationalism	nationalism		NOUN-Number=Sing
nationality	nationality		NOUN-Number=Sing
national	national		ADJ-Degree=Pos
na	to		PART-Abbr=Yes
natrually	natrually		ADV
natural	natural		ADJ-Degree=Pos
nearby	nearby		ADJ-Degree=Pos
nearest	nearest		ADJ-Degree=Sup
nearly	nearly		ADV
near	near		ADP
neat	neat		ADJ-Degree=Pos
necessary	necessary		ADJ-Degree=Pos
needed	need		VERB-Mood=Ind|Tense=Past|VerbForm=Fin
needed	need		VERB-Tense=Past|VerbForm=Part
needed	need		VERB-Tense=Past|VerbForm=Part|Voice=Pass
needing	need		VERB-VerbForm=Ger
need	need		NOUN-Number=Sing
need	need		VERB-Mood=Ind|Tense=Pres|VerbForm=Fin
need	need		VERB-VerbForm=Inf
needs	need		NOUN-Number=Plur
needs	need		VERB-Mood=Ind|Number=Sing|Person=3|Tense=Pres|VerbForm=Fin
negative	negative		ADJ-Degree=Pos
negotiations	negotiation		NOUN-Number=Plur
neighbourhood	neighbourhood		NOUN-Number=Sing
neither	neither		CCONJ
net	net		ADJ-Degree=Pos
never	never		ADV
newlywed	newlywed		ADJ-Degree=Pos
new	new		ADJ-Degree=Pos
news	news		NOUN-Number=Sing
newspaper	newspaper		NOUN-Number=Sing
next	next		ADJ-Degree=Pos
next	next		ADV
nice	nice		ADJ-Degree=Pos
nicer	nicer		ADJ-Degree=Cmp
nicest	nicest		ADJ-Degree=Pos
nightgown	nightgown		NOUN-Number=Sing
nightie	nightie		NOUN-Number=Sing
night	night		NOUN-Number=Sing
nights	night		NOUN-Number=Plur
n	not		PART
no	know		VERB-VerbForm=Inf
nominated	nominate		VERB-Mood=Ind|Tense=Past|VerbForm=Fin
nominee	nominee		NOUN-Number=Sing
noncombatants	noncombatant		NOUN-Number=Plur
none	none		NOUN-Number=Sing
nonessential	nonessential		ADJ-Degree=Pos
non-human	non-human		ADJ-Degree=Pos
non-Microsoft	non-microsoft		ADJ-Degree=Pos
no	no		ADV
no	no		DET
no	no		INTJ
normal	normal		ADJ-Degree=Pos
norm	norm		VERB-VerbForm=Inf
nor	nor		CCONJ
northern	northern		ADJ-Degree=Pos
north	north		ADV
northwest	northwest		NOUN-Number=Sing
notation	notation		NOUN-Number=Sing
notch	notch		NOUN-Number=Sing
note	note		NOUN-Number=Sing
nothing	nothing		PRON-Number=Sing
noticeable	noticeable		ADJ-Degree=Pos
notice	notice		VERB-VerbForm=Inf
notification	notification		NOUN-Number=Sing
notified	notify		VERB-Tense=Past|VerbForm=Part|Voice=Pass
notifying	notify		VERB-VerbForm=Ger
notify	notify		VERB-Mood=Imp|VerbForm=Fin
notify	notify		VERB-VerbForm=Inf
notions	notion		NOUN-Number=Plur
not	not		ADV
not	not		CCONJ
not	not		PART
$$$	$$$		NOUN-Number=Sing
#	#		NOUN-Number=Sing
now	now		ADV
n't	not		PART
nt	not		PART
nuclear	nuclear		ADJ-Degree=Pos
nukes	nuke		NOUN-Number=Plur
number	number		NOUN-Number=Sing
numbers	number		NOUN-Number=Plur
numerous	numerous		ADJ-Degree=Pos
nymex	nymex		NOUN-Number=Sing
observations	observation		NOUN-Number=Plur
obvious	obvious		ADJ-Degree=Pos
occupation	occupation		NOUN-Number=Sing
occupied	occupy		VERB-Tense=Past|VerbForm=Part
occupies	occupy		VERB-Mood=Ind|Number=Sing|Person=3|Tense=Pres|VerbForm=Fin
occupy	occupy		VERB-VerbForm=Inf
occur	occur		VERB-VerbForm=Inf
offended	offend		VERB-Tense=Past|VerbForm=Part|Voice=Pass
offensive	offensive		ADJ-Degree=Pos
offer	offer		NOUN-Number=Sing
offer	offer		VERB-Mood=Ind|Tense=Pres|VerbForm=Fin
offers	offer		NOUN-Number=Plur
office	office		NOUN-Number=Sing
officers	officer		NOUN-Number=Plur
offices	office		NOUN-Number=Plur
officially	officially		ADV
official	official		ADJ-Degree=Pos
official	official		NOUN-Number=Sing
officials	official		NOUN-Number=Plur
off	off		ADP
off	off		ADV
offshore	offshore		ADJ-Degree=Pos
of	of		ADP
of	of		ADV
of	of		SCONJ
often	often		ADV
oil	oil		NOUN-Number=Sing
okay	okay		ADJ-Degree=Pos
okay	okay		INTJ
ok	ok		ADJ-Degree=Pos
ok	ok		INTJ
old	old		ADJ-Degree=Pos
once	once		ADV-NumType=Mult
once	once		SCONJ
one	one		NOUN-Number=Sing
one	one		PRON
ones	one		NOUN-Number=Plur
onion	onion		NOUN-Number=Sing
online	online		ADJ-Degree=Pos
online	online		ADV
only	only		ADJ-Degree=Pos
only	only		ADV
on	on		ADP
on	on		ADV
on	on		NOUN-Number=Sing
on	on		SCONJ
onto	onto		ADP
oolong	oolong		NOUN-Number=Sing
opened	open		VERB-Mood=Ind|Tense=Past|VerbForm=Fin
opening	opening		NOUN-Number=Sing
opening	open		VERB-VerbForm=Ger
open	open		ADJ-Degree=Pos
open	open		VERB-VerbForm=Inf
opens	open		VERB-Mood=Ind|Number=Sing|Person=3|Tense=Pres|VerbForm=Fin
operation	operation		NOUN-Number=Sing
operations	operation		NOUN-Number=Plur
opinion	opinion		NOUN-Number=Sing
opinions	opinion		NOUN-Number=Plur
opportunity	opportunity		NOUN-Number=Sing
opposed	oppose		VERB-Tense=Past|VerbForm=Part
oppose	oppose		VERB-Mood=Ind|Tense=Pres|VerbForm=Fin
option	option		NOUN-Number=Sing
options	option		NOUN-Number=Plur
orchestra	orchestra		NOUN-Number=Sing
order	order		NOUN-Number=Sing
order	order		VERB-Mood=Ind|Tense=Pres|VerbForm=Fin
order	order		VERB-VerbForm=Inf
ordinary	ordinary		ADJ-Degree=Pos
organisation	organisation		NOUN-Number=Sing
organization	organization		NOUN-Number=Sing
organizations	organization		NOUN-Number=Plur
organizer	organizer		NOUN-Number=Sing
original	original		NOUN-Number=Sing
origin	origin		NOUN-Number=Sing
or	or		CCONJ
other	other		ADJ-Degree=Pos
other	other		ADV
others	other		NOUN-Number=Plur
otherwise	otherwise		ADV
our	we		PRON-Number=Plur|Person=1|Poss=Yes|PronType=Prs
outbreak	outbreak		NOUN-Number=Sing
outcome	outcome		NOUN-Number=Sing
outdated	outdated		ADJ-Degree=Pos
outfit	outfit		NOUN-Number=Sing
out	out		ADP
out	out		ADV
out	out		NOUN-Number=Sing
outrageous	outrageous		ADJ-Degree=Pos
outside	outside		ADP
outside	outside		ADV
outstanding	outstanding		ADJ-Degree=Pos
overall	overall		ADV
over-eater	over-eater		NOUN-Number=Sing
overnight	overnight		ADV
over	over		ADP
over	over		ADV
over	over		NOUN-Number=Sing
overpriced	overpriced		ADJ-Degree=Pos
overstating	overstate		VERB-VerbForm=Ger
owned	own		VERB-Tense=Past|VerbForm=Part
owner	owner		NOUN-Number=Sing
owners	owner		NOUN-Number=Plur
own	own		ADJ-Degree=Pos
packages	package		NOUN-Number=Plur
packed	pack		VERB-Mood=Ind|Tense=Past|VerbForm=Fin
pack	pack		VERB-VerbForm=Inf
pad	pad		NOUN-Number=Sing
page	page		NOUN-Number=Sing
paid	pay		VERB-Tense=Past|VerbForm=Part
paid	pay		VERB-Tense=Past|VerbForm=Part|Voice=Pass
pain	pain		NOUN-Number=Sing
painting	painting		NOUN-Number=Sing
paint	paint		NOUN-Number=Sing
pander	pander		VERB-VerbForm=Inf
panties	panties		NOUN-Number=Plur
pants	pants		NOUN-Number=Plur
paper	paper		NOUN-Number=Sing
papers	papers		NOUN-Number=Plur
parakeets	parakeet		NOUN-Number=Plur
parking	parking		NOUN-Number=Sing
park	park		NOUN-Number=Sing
partially	partially		ADV
participants	participant		NOUN-Number=Plur
participation	participation		NOUN-Number=Sing
particularly	particularly		ADV
particular	particular		ADJ-Degree=Pos
parties	party		NOUN-Number=Plur
partner	partner		NOUN-Number=Sing
part	part		ADJ-Degree=Pos
part	part		NOUN-Number=Sing
parts	part		NOUN-Number=Plur
party	party		NOUN-Number=Sing
party	party		VERB-VerbForm=Inf
passable	passable		ADJ-Degree=Pos
passengers	passenger		NOUN-Number=Plur
passing	passing		NOUN-Number=Sing
passing	pass		VERB-VerbForm=Ger
pass	pass		VERB-VerbForm=Inf
passport	passport		NOUN-Number=Sing
past	past		ADJ-Degree=Pos
past	past		NOUN-Number=Sing
past	past		SCONJ
path	path		NOUN-Number=Sing
patience	patience		NOUN-Number=Sing
patient	patient		NOUN-Number=Sing
pattern	pattern		NOUN-Number=Sing
@paulhastings.com	@paulhastings.com		NOUN-Number=Sing
paying	pay		VERB-VerbForm=Ger
payment	payment		NOUN-Number=Sing
payments	payment		NOUN-Number=Plur
pay	pay		VERB-Mood=Ind|Tense=Pres|VerbForm=Fin
pay	pay		VERB-VerbForm=Inf
pdf	pdf		NOUN-Number=Sing
peace	peace		NOUN-Number=Sing
peaking	peak		VERB-VerbForm=Ger
pearl	pearl		NOUN-Number=Sing
pedi	pedi		NOUN-Number=Sing
pencil	pencil		NOUN-Number=Sing
peopel	peopel		NOUN-Number=Plur
people	people		NOUN-Number=Plur
pepper	pepper		NOUN-Number=Sing
perfect	perfect		ADJ-Degree=Pos
perform	perform		VERB-VerbForm=Inf
period	period		NOUN-Number=Sing
permanent	permanent		ADJ-Degree=Pos
per	per		ADP
personable	personable		ADJ-Degree=Pos
personality	personality		NOUN-Number=Sing
personally	personally		ADV
personal	personal		ADJ-Degree=Pos
person	person		NOUN-Number=Sing
persons	person		NOUN-Number=Plur
pertains	pertain		VERB-Mood=Ind|Number=Sing|Person=3|Tense=Pres|VerbForm=Fin
perverted	perverted		ADJ-Degree=Pos
pet	pet		NOUN-Number=Sing
pets	pet		NOUN-Number=Plur
phenomenon	phenomenon		NOUN-Number=Sing
phone	phone		NOUN-Number=Sing
phone	phone		VERB-VerbForm=Inf
photographer	photographer		NOUN-Number=Sing
photography	photography		NOUN-Number=Sing
photos	photo		NOUN-Number=Plur
phrase	phrase		NOUN-Number=Sing
physical	physical		ADJ-Degree=Pos
piano	piano		NOUN-Number=Sing
picking	pick		VERB-VerbForm=Ger
pick	pick		VERB-VerbForm=Inf
pictures	picture		NOUN-Number=Plur
piece	piece		NOUN-Number=Sing
pie	pie		NOUN-Number=Sing
pies	pie		NOUN-Number=Plur
pigment	pigment		NOUN-Number=Sing
pilot	pilot		NOUN-Number=Sing
pinchers	pincher		NOUN-Number=Plur
piss	piss		NOUN-Number=Sing
pizza	pizza		NOUN-Number=Sing
pizzas	pizza		NOUN-Number=Plur
placed	place		VERB-Tense=Past|VerbForm=Part
place	place		NOUN-Number=Sing
place	place		VERB-VerbForm=Inf
places	place		NOUN-Number=Plur
plaintiffs	plaintiff		NOUN-Number=Plur
plane	plane		NOUN-Number=Sing
planetary	planetary		ADJ-Degree=Pos
plan	plan		NOUN-Number=Sing
plans	plan		NOUN-Number=Plur
plant	plant		NOUN-Number=Sing
plants	plant		NOUN-Number=Plur
platform	platform		NOUN-Number=Sing
play	play		VERB-VerbForm=Inf
plays	play		NOUN-Number=Plur
pleasantly	pleasantly		ADV
pleasant	pleasant		ADJ-Degree=Pos
pleased	pleased		ADJ-Degree=Pos
please	please		INTJ
pleasure	pleasure		NOUN-Number=Sing
pledged	pledge		VERB-Mood=Ind|Tense=Past|VerbForm=Fin
pledge	pledge		NOUN-Number=Sing
pledging	pledging		NOUN-Number=Sing
plllz	plllz		INTJ
pls	pls		INTJ
plumbing	plumbing		NOUN-Number=Sing
plus	plus		CCONJ
plus	plus		NOUN-Number=Sing
ply	ply		VERB-Mood=Ind|Tense=Pres|VerbForm=Fin
pockets	pocket		NOUN-Number=Plur
pod	pod		NOUN-Number=Sing
point	point		NOUN-Number=Sing
police	police		NOUN-Number=Plur
police	police		NOUN-Number=Sing
policy	policy		NOUN-Number=Sing
polite	polite		ADJ-Degree=Pos
political	political		ADJ-Degree=Pos
poll	poll		NOUN-Number=Sing
pool	pool		NOUN-Number=Sing
poor	poor		ADJ-Degree=Pos
po	po		NOUN-Number=Sing
popular	popular		ADJ-Degree=Pos
population	population		NOUN-Number=Sing
pork	pork		NOUN-Number=Sing
portals	portal		NOUN-Number=Plur
portion	portion		NOUN-Number=Sing
portions	portion		NOUN-Number=Plur
position	position		NOUN-Number=Sing
positive	positive		ADJ-Degree=Pos
posses	poss		VERB-Mood=Ind|Tense=Pres|VerbForm=Fin
possible	possible		ADJ-Degree=Pos
possibly	possibly		ADV
posted	post		VERB-Tense=Past|VerbForm=Part
posters	poster		NOUN-Number=Plur
posting	posting		NOUN-Number=Sing
postponed	postpone		VERB-Tense=Past|VerbForm=Part|Voice=Pass
post	post		NOUN-Number=Sing
post	post		VERB-Mood=Ind|Tense=Pres|VerbForm=Fin
post	post		VERB-VerbForm=Inf
posts	post		NOUN-Number=Plur
potatoes	potato		NOUN-Number=Plur
potential	potential		ADJ-Degree=Pos
power	power		NOUN-Number=Sing
p	p		NOUN-Number=Sing
:P	:p		SYM
praise	praise		VERB-VerbForm=Inf
prayer	prayer		NOUN-Number=Sing
pray	pray		VERB-VerbForm=Inf
preceding	precede		VERB-VerbForm=Ger
precious	precious		ADJ-Degree=Pos
predictable	predictable		ADJ-Degree=Pos
predicted	predict		VERB-Tense=Past|VerbForm=Part
predominance	predominance		NOUN-Number=Sing
preety	preety		ADV
preferably	preferably		ADV
preference	preference		NOUN-Number=Sing
prefer	prefer		VERB-VerbForm=Inf
pregnant	pregnant		ADJ-Degree=Pos
preliminary	preliminary		ADJ-Degree=Pos
premature	premature		ADJ-Degree=Pos
premise	premise		NOUN-Number=Sing
prepared	prepare		VERB-Tense=Past|VerbForm=Part|Voice=Pass
prepare	prepare		VERB-VerbForm=Inf
presented	present		VERB-Mood=Ind|Tense=Past|VerbForm=Fin
present	present		ADJ-Degree=Pos
present	present		VERB-VerbForm=Inf
presidential	presidential		ADJ-Degree=Pos
prestige	prestige		NOUN-Number=Sing
prettty	prettty		ADV
pretty	pretty		ADV
prevented	prevent		VERB-Mood=Ind|Tense=Past|VerbForm=Fin
prevention	prevention		NOUN-Number=Sing
previously	previously		ADV
priced	priced		ADJ-Degree=Pos
price	price		NOUN-Number=Sing
prices	price		NOUN-Number=Plur
pricey	pricey		ADJ-Degree=Pos
principally	principally		ADV
principles	principle		NOUN-Number=Plur
printed	print		VERB-Mood=Ind|Tense=Past|VerbForm=Fin
print	print		VERB-VerbForm=Inf
priorities	priority		NOUN-Number=Plur
prior	prior		ADJ-Degree=Pos
prison	prison		NOUN-Number=Sing
privacy	privacy		NOUN-Number=Sing
private	private		ADJ-Degree=Pos
privileged	privileged		ADJ-Degree=Pos
prizes	prize		NOUN-Number=Plur
probably	probably		ADV
problem	problem		NOUN-Number=Sing
problems	problem		NOUN-Number=Plur
procedure	procedure		NOUN-Number=Sing
proceed	proceed		VERB-VerbForm=Inf
processor	processor		NOUN-Number=Sing
process	process		NOUN-Number=Sing
production	production		NOUN-Number=Sing
product	product		NOUN-Number=Sing
products	product		NOUN-Number=Plur
professional	professional		ADJ-Degree=Pos
professional	professional		NOUN-Number=Sing
profiled	profile		VERB-Tense=Past|VerbForm=Part
profitable	profitable		ADJ-Degree=Pos
profit	profit		NOUN-Number=Sing
program	program		NOUN-Number=Sing
progress	progress		NOUN-Number=Sing
prohibited	prohibit		VERB-Tense=Past|VerbForm=Part|Voice=Pass
project	project		NOUN-Number=Sing
projects	project		NOUN-Number=Plur
promised	promise		VERB-Mood=Ind|Tense=Past|VerbForm=Fin
promised	promise		VERB-Tense=Past|VerbForm=Part
promises	promise		NOUN-Number=Plur
promises	promise		VERB-Mood=Ind|Number=Sing|Person=3|Tense=Pres|VerbForm=Fin
promote	promote		VERB-Mood=Ind|Tense=Pres|VerbForm=Fin
promotional	promotional		NOUN-Number=Sing
prompt	prompt		ADJ-Degree=Pos
proof	proof		NOUN-Number=Sing
properly	properly		ADV
proper	proper		ADJ-Degree=Pos
properties	property		NOUN-Number=Plur
property	property		NOUN-Number=Sing
prophet	prophet		NOUN-Number=Sing
proposal	proposal		NOUN-Number=Sing
proposed	propose		VERB-Mood=Ind|Tense=Past|VerbForm=Fin
proposed	propose		VERB-Tense=Past|VerbForm=Part
propose	propose		VERB-Mood=Ind|Tense=Pres|VerbForm=Fin
protecting	protect		VERB-VerbForm=Ger
protect	protect		VERB-VerbForm=Inf
protest	protest		NOUN-Number=Sing
proud	proud		ADJ-Degree=Pos
prove	prove		VERB-VerbForm=Inf
proves	prove		VERB-Mood=Ind|Number=Sing|Person=3|Tense=Pres|VerbForm=Fin
provided	provide		VERB-Tense=Past|VerbForm=Part
provide	provide		VERB-Mood=Ind|Tense=Pres|VerbForm=Fin
provide	provide		VERB-VerbForm=Inf
providers	provider		NOUN-Number=Plur
provides	provide		VERB-Mood=Ind|Number=Sing|Person=3|Tense=Pres|VerbForm=Fin
providing	provide		VERB-VerbForm=Ger
provision	provision		NOUN-Number=Sing
provisions	provision		NOUN-Number=Plur
provoked	provoke		VERB-Mood=Ind|Tense=Past|VerbForm=Fin
provoked	provoke		VERB-Tense=Past|VerbForm=Part
provoked	provoke		VERB-Tense=Past|VerbForm=Part|Voice=Pass
provoke	provoke		VERB-VerbForm=Inf
provoking	provoke		VERB-VerbForm=Ger
publication	publication		NOUN-Number=Sing
public	public		ADJ-Degree=Pos
published	publish		VERB-Tense=Past|VerbForm=Part
pub	pub		NOUN-Number=Sing
pudding	pudding		NOUN-Number=Sing
pull	pull		VERB-VerbForm=Inf
punchline	punchline		NOUN-Number=Sing
~	~		PUNCT
<<	<<		PUNCT
<	<		PUNCT
>>	>>		PUNCT
>	>		PUNCT
------------------------------------------------	------------------------------------------------		PUNCT
---	---		PUNCT
--	--		PUNCT
-	-		PUNCT
,	,		PUNCT
;	;		PUNCT
:?	:?		PUNCT
:	:		PUNCT
!!!!!!!!!!!!!!!!!!!!!!!!!	!!!!!!!!!!!!!!!!!!!!!!!!!		PUNCT
!!!!!!!!!!!!!?	!!!!!!!!!!!!!?		PUNCT
!!!!!!!!!!	!!!!!!!!!!		PUNCT
!!!!!!!	!!!!!!!		PUNCT
!!!!	!!!!		PUNCT
!!!	!!!		PUNCT
!!	!!		PUNCT
!?!?!	!?!?!		PUNCT
!?????!!!!	!?????!!!!		PUNCT
!?	!?		PUNCT
!.	!.		PUNCT
!	!		PUNCT
?!	?!		PUNCT
?????????????????????????????????????????????????????????	?????????????????????????????????????????????????????????		PUNCT
??.	??.		PUNCT
??	??		PUNCT
?	?		PUNCT
/	/		PUNCT
.?	.?		PUNCT
..?	..?		PUNCT
..........	..........		PUNCT
.........	.........		PUNCT
.......	.......		PUNCT
......	......		PUNCT
....	....		PUNCT
...	...		PUNCT
..	..		PUNCT
.	.		PUNCT
'	'		PUNCT
"	"		PUNCT
	"		PUNCT
	"		PUNCT
(	(		PUNCT
)	)		PUNCT
[	[		PUNCT
]	]		PUNCT
************************************************	************************************************		PUNCT
*************************************	*************************************		PUNCT
********************************	********************************		PUNCT
***	***		PUNCT
			PUNCT
punishment	punishment		NOUN-Number=Sing
pup	pup		NOUN-Number=Sing
puppy	puppy		NOUN-Number=Sing
purchased	purchase		VERB-Mood=Ind|Tense=Past|VerbForm=Fin
purchase	purchase		NOUN-Number=Sing
purchase	purchase		VERB-VerbForm=Inf
purpose	purpose		NOUN-Number=Sing
purrs	purr		NOUN-Number=Plur
pursue	pursue		VERB-VerbForm=Inf
put	put		VERB-Mood=Imp|VerbForm=Fin
put	put		VERB-Tense=Past|VerbForm=Part
put	put		VERB-Tense=Past|VerbForm=Part|Voice=Pass
put	put		VERB-VerbForm=Inf
puts	put		VERB-Mood=Ind|Number=Sing|Person=3|Tense=Pres|VerbForm=Fin
qualified	qualified		ADJ-Degree=Pos
qualified	qualify		VERB-Mood=Ind|Tense=Past|VerbForm=Fin
quality	quality		ADJ-Degree=Pos
quality	quality		NOUN-Number=Sing
quarter	quarter		NOUN-Number=Sing
question	question		NOUN-Number=Sing
questionsand	questionsand		NOUN-Number=Plur
questions	question		NOUN-Number=Plur
quickly	quickly		ADV
quick	quick		ADJ-Degree=Pos
quiet	quiet		ADJ-Degree=Pos
quite	quite		ADV
quitting	quit		VERB-VerbForm=Ger
quote	quote		VERB-VerbForm=Inf
quotes	quote		NOUN-Number=Plur
radical	radical		ADJ-Degree=Pos
raffle	raffle		NOUN-Number=Sing
rail	rail		NOUN-Number=Sing
rained	rain		VERB-Mood=Ind|Tense=Past|VerbForm=Fin
rainforest	rainforest		NOUN-Number=Sing
raises	raise		VERB-Mood=Ind|Number=Sing|Person=3|Tense=Pres|VerbForm=Fin
rambling	rambling		ADJ-Degree=Pos
ramp	ramp		NOUN-Number=Sing
random	random		ADJ-Degree=Pos
range	range		NOUN-Number=Sing
ranks	rank		NOUN-Number=Plur
ranks	rank		VERB-Mood=Ind|Number=Sing|Person=3|Tense=Pres|VerbForm=Fin
ran	run		VERB-Mood=Ind|Tense=Past|VerbForm=Fin
rate	rate		NOUN-Number=Sing
rates	rate		NOUN-Number=Plur
rather	rather		ADV
rat	rat		NOUN-Number=Sing
r	be		AUX-Mood=Ind|Tense=Pres|VerbForm=Fin
reached	reach		VERB-Tense=Past|VerbForm=Part
reaches	reach		NOUN-Number=Plur
reach	reach		VERB-VerbForm=Inf
react	react		VERB-Mood=Ind|Tense=Pres|VerbForm=Fin
reading	read		VERB-VerbForm=Ger
read	read		VERB-Mood=Imp|VerbForm=Fin
read	read		VERB-Tense=Past|VerbForm=Part
read	read		VERB-VerbForm=Inf
reads	read		VERB-Mood=Ind|Number=Sing|Person=3|Tense=Pres|VerbForm=Fin
ready	ready		ADJ-Degree=Pos
realisation	realisation		NOUN-Number=Sing
realize	realize		VERB-VerbForm=Inf
really	really		ADV
real	real		ADJ-Degree=Pos
real	real		ADV
reasonable	reasonable		ADJ-Degree=Pos
reasonably	reasonably		ADV
reason	reason		NOUN-Number=Sing
reasons	reason		NOUN-Number=Plur
're	be		AUX-Mood=Ind|Tense=Pres|VerbForm=Fin
receipt	receipt		NOUN-Number=Sing
received	receive		VERB-Mood=Ind|Tense=Past|VerbForm=Fin
received	receive		VERB-Tense=Past|VerbForm=Part
receive	receive		VERB-Mood=Ind|Tense=Pres|VerbForm=Fin
receive	receive		VERB-VerbForm=Inf
recently	recently		ADV
recent	recent		ADJ-Degree=Pos
recipe	recipe		NOUN-Number=Sing
recipient	recipient		NOUN-Number=Sing
recognized	recognize		VERB-VerbForm=Inf
recomend	recomend		VERB-Mood=Ind|Tense=Pres|VerbForm=Fin
recomend	recomend		VERB-VerbForm=Inf
recommended	recommended		ADJ-Degree=Pos
recommended	recommend		VERB-Tense=Past|VerbForm=Part
recommend	recommend		VERB-Mood=Ind|Tense=Pres|VerbForm=Fin
recommend	recommend		VERB-VerbForm=Inf
recording	recording		NOUN-Number=Sing
recordkeeping	recordkeeping		NOUN-Number=Sing
record	record		ADJ-Degree=Pos
recovery	recovery		NOUN-Number=Sing
recruiting	recruiting		NOUN-Number=Sing
recruits	recruit		VERB-Mood=Ind|Number=Sing|Person=3|Tense=Pres|VerbForm=Fin
recycled	recycle		VERB-Tense=Past|VerbForm=Part
redevelopment	redevelopment		NOUN-Number=Sing
redlined	redline		VERB-Tense=Past|VerbForm=Part
red	red		VERB-Mood=Ind|Tense=Past|VerbForm=Fin
reducing	reduce		VERB-Tense=Pres|VerbForm=Part
reel	reel		NOUN-Number=Sing
referenced	reference		VERB-Tense=Past|VerbForm=Part
reference	reference		NOUN-Number=Sing
referencing	reference		VERB-Tense=Pres|VerbForm=Part
referred	refer		VERB-Tense=Past|VerbForm=Part
refer	refer		VERB-VerbForm=Inf
refineries	refinery		NOUN-Number=Plur
refinery	refinery		NOUN-Number=Sing
reflected	reflect		VERB-Tense=Past|VerbForm=Part
refugee	refugee		NOUN-Number=Sing
refugees	refugee		NOUN-Number=Plur
refused	refuse		VERB-Tense=Past|VerbForm=Part
refusing	refuse		VERB-VerbForm=Ger
regarding	regard		VERB-VerbForm=Ger
regards	regards		NOUN-Number=Plur
region	region		NOUN-Number=Sing
regions	region		NOUN-Number=Plur
registration	registration		NOUN-Number=Sing
regularly	regularly		ADV
regular	regular		ADJ-Degree=Pos
reigns	reign		NOUN-Number=Plur
reintroduced	reintroduce		VERB-Mood=Ind|Tense=Past|VerbForm=Fin
reinvigorate	reinvigorate		VERB-VerbForm=Inf
relate	relate		VERB-Mood=Ind|Tense=Pres|VerbForm=Fin
relationship	relationship		NOUN-Number=Sing
relationships	relationship		NOUN-Number=Plur
relatives	relative		NOUN-Number=Plur
relaxing	relaxing		ADJ-Degree=Pos
relax	relax		VERB-VerbForm=Inf
released	release		VERB-Mood=Ind|Tense=Past|VerbForm=Fin
released	release		VERB-Tense=Past|VerbForm=Part
release	release		NOUN-Number=Sing
release	release		VERB-VerbForm=Inf
releases	release		NOUN-Number=Plur
releif	releif		NOUN-Number=Sing
relentlessly	relentlessly		ADV
reliable	reliable		ADJ-Degree=Pos
reliance	reliance		NOUN-Number=Sing
religious	religious		ADJ-Degree=Pos
reluctant	reluctant		ADJ-Degree=Pos
remained	remain		VERB-Mood=Ind|Tense=Past|VerbForm=Fin
remain	remain		VERB-Mood=Ind|Tense=Pres|VerbForm=Fin
remain	remain		VERB-VerbForm=Inf
remains	remain		VERB-Mood=Ind|Number=Sing|Person=3|Tense=Pres|VerbForm=Fin
remarking	remark		VERB-Tense=Pres|VerbForm=Part
remember	remember		VERB-Mood=Ind|Tense=Pres|VerbForm=Fin
remember	remember		VERB-VerbForm=Inf
reminding	remind		VERB-VerbForm=Ger
remote	remote		ADJ-Degree=Pos
removal	removal		NOUN-Number=Sing
removed	remove		VERB-Tense=Past|VerbForm=Part
removed	remove		VERB-Tense=Past|VerbForm=Part|Voice=Pass
repair	repair		NOUN-Number=Sing
repairs	repair		NOUN-Number=Plur
repeat	repeat		NOUN-Number=Sing
repeat	repeat		VERB-Mood=Ind|Tense=Pres|VerbForm=Fin
replaced	replace		VERB-Tense=Past|VerbForm=Part
replaced	replace		VERB-Tense=Past|VerbForm=Part|Voice=Pass
replacement	replacement		NOUN-Number=Sing
replace	replace		VERB-VerbForm=Inf
replacing	replace		VERB-VerbForm=Ger
reply	reply		NOUN-Number=Sing
reported	report		VERB-Mood=Ind|Tense=Past|VerbForm=Fin
reporters	reporter		NOUN-Number=Plur
report	report		NOUN-Number=Sing
reports	report		VERB-Mood=Ind|Number=Sing|Person=3|Tense=Pres|VerbForm=Fin
represent	represent		VERB-VerbForm=Inf
reprint	reprint		NOUN-Number=Sing
request	request		NOUN-Number=Sing
require	require		VERB-Mood=Ind|Tense=Pres|VerbForm=Fin
re	re		ADP
rescue	rescue		VERB-VerbForm=Inf
research	research		NOUN-Number=Sing
reserved	reserve		VERB-Tense=Past|VerbForm=Part|Voice=Pass
residents	resident		NOUN-Number=Plur
resistance	resistance		NOUN-Number=Sing
resolve	resolve		VERB-VerbForm=Inf
resort	resort		NOUN-Number=Sing
resorts	resort		NOUN-Number=Plur
respectable	respectable		ADJ-Degree=Pos
respected	respect		VERB-Tense=Past|VerbForm=Part
respectively	respectively		ADV
respect	respect		NOUN-Number=Sing
respects	respects		NOUN-Number=Plur
response	response		NOUN-Number=Sing
responsibilities	responsibility		NOUN-Number=Plur
responsibility	responsibility		NOUN-Number=Sing
responsible	responsible		ADJ-Degree=Pos
restaurant	restaurant		NOUN-Number=Sing
restaurants	restaurant		NOUN-Number=Plur
restraunt	restraunt		NOUN-Number=Sing
restraunts	restraunt		NOUN-Number=Plur
rest	rest		ADJ-Degree=Pos
rest	rest		NOUN-Number=Sing
resulted	result		VERB-Tense=Past|VerbForm=Part
resulting	result		VERB-VerbForm=Ger
result	result		NOUN-Number=Sing
results	result		NOUN-Number=Plur
resumed	resume		VERB-Mood=Ind|Tense=Past|VerbForm=Fin
resume	resume		NOUN-Number=Sing
retaliation	retaliation		NOUN-Number=Sing
retired	retire		VERB-Mood=Ind|Tense=Past|VerbForm=Fin
retire	retire		VERB-Mood=Imp|VerbForm=Fin
retiring	retire		VERB-VerbForm=Ger
retransmission	retransmission		NOUN-Number=Sing
returned	return		VERB-Tense=Past|VerbForm=Part|Voice=Pass
return	return		NOUN-Number=Sing
return	return		VERB-VerbForm=Inf
reveal	reveal		VERB-VerbForm=Inf
reveals	reveal		VERB-Mood=Ind|Number=Sing|Person=3|Tense=Pres|VerbForm=Fin
revenge	revenge		NOUN-Number=Sing
reversion	reversion		NOUN-Number=Sing
reviewing	review		VERB-VerbForm=Ger
review	review		NOUN-Number=Sing
reviews	review		NOUN-Number=Plur
revised	revise		VERB-Mood=Ind|Tense=Past|VerbForm=Fin
revised	revise		VERB-Tense=Past|VerbForm=Part
revising	revise		VERB-VerbForm=Ger
revisionist	revisionist		NOUN-Number=Sing
revolutionize	revolutionize		VERB-VerbForm=Inf
rewarding	rewarding		ADJ-Degree=Pos
re-wording	re-wording		NOUN-Number=Sing
rib	rib		NOUN-Number=Sing
rice	rice		NOUN-Number=Sing
ride	ride		NOUN-Number=Sing
ridiculously	ridiculously		ADV
rid	rid		ADJ-Degree=Pos
right	right		ADJ-Degree=Pos
right	right		ADV
right	right		INTJ
right	right		NOUN-Number=Sing
rights	rights		NOUN-Number=Plur
rig	rig		NOUN-Number=Sing
rip	rip		VERB-VerbForm=Inf
risk	risk		VERB-VerbForm=Inf
risks	risk		VERB-Mood=Ind|Number=Sing|Person=3|Tense=Pres|VerbForm=Fin
road	road		NOUN-Number=Sing
rocket	rocket		NOUN-Number=Sing
rockets	rocket		NOUN-Number=Plur
rock	rock		NOUN-Number=Sing
rock	rock		VERB-VerbForm=Inf
rocky	rocky		ADJ-Degree=Pos
rodent	rodent		NOUN-Number=Sing
role	role		NOUN-Number=Sing
rolled	roll		VERB-Mood=Ind|Tense=Past|VerbForm=Fin
rolls	roll		NOUN-Number=Plur
romantic	romantic		ADJ-Degree=Pos
room	room		NOUN-Number=Sing
rooms	room		NOUN-Number=Plur
roots	root		NOUN-Number=Plur
rose	rise		VERB-Mood=Ind|Tense=Past|VerbForm=Fin
rotating	rotate		VERB-Tense=Pres|VerbForm=Part
rot	rot		VERB-VerbForm=Inf
round	round		NOUN-Number=Sing
rubber	rubber		NOUN-Number=Sing
ruder	ruder		ADJ-Degree=Cmp
rude	rude		ADJ-Degree=Pos
rug	rug		NOUN-Number=Sing
rule	rule		NOUN-Number=Sing
rule	rule		VERB-VerbForm=Inf
ruling	rule		VERB-VerbForm=Ger
rumored	rumor		VERB-Tense=Past|VerbForm=Part|Voice=Pass
runner	runner		NOUN-Number=Sing
running	run		VERB-VerbForm=Ger
run	run		VERB-Tense=Past|VerbForm=Part
runs	run		VERB-Mood=Ind|Number=Sing|Person=3|Tense=Pres|VerbForm=Fin
rush	rush		VERB-VerbForm=Inf
sacrifice	sacrifice		NOUN-Number=Sing
sadists	sadist		NOUN-Number=Plur
sad	sad		ADJ-Degree=Pos
safely	safely		ADV
safe	safe		ADJ-Degree=Pos
said	say		VERB-Mood=Ind|Tense=Past|VerbForm=Fin
said	say		VERB-Tense=Past|VerbForm=Part
said	say		VERB-Tense=Past|VerbForm=Part|Voice=Pass
salad	salad		NOUN-Number=Sing
salon	salon		NOUN-Number=Sing
same	same		ADJ-Degree=Pos
sample	sample		NOUN-Number=Sing
sandwich	sandwich		NOUN-Number=Sing
sang	sing		VERB-Mood=Ind|Tense=Past|VerbForm=Fin
satellite	satellite		NOUN-Number=Sing
satire	satire		NOUN-Number=Sing
satisfied	satisfied		ADJ-Degree=Pos
satisfying	satisfying		ADJ-Degree=Pos
satisfy	satisfy		VERB-Mood=Ind|Tense=Pres|VerbForm=Fin
sat	sit		VERB-Mood=Ind|Tense=Past|VerbForm=Fin
sausages	sausage		NOUN-Number=Plur
save	save		VERB-VerbForm=Inf
saw	see		VERB-Mood=Ind|Tense=Past|VerbForm=Fin
saying	say		VERB-Tense=Pres|VerbForm=Part
saying	say		VERB-VerbForm=Ger
say	say		INTJ
say	say		VERB-Mood=Ind|Tense=Pres|VerbForm=Fin
say	say		VERB-VerbForm=Inf
says	say		VERB-Mood=Ind|Number=Sing|Person=3|Tense=Pres|VerbForm=Fin
's	be		AUX-Mood=Ind|Number=Sing|Person=3|Tense=Pres|VerbForm=Fin
s	be		AUX-Mood=Ind|Number=Sing|Person=3|Tense=Pres|VerbForm=Fin
s	be		AUX-Mood=Ind|Number=Sing|Person=3|Tense=Pres|VerbForm=Fin
'S	be		AUX-Mood=Ind|Number=Sing|Person=3|Tense=Pres|VerbForm=Fin
's	be		VERB-Mood=Ind|Number=Sing|Person=3|Tense=Pres|VerbForm=Fin
s	be		VERB-Mood=Ind|Number=Sing|Person=3|Tense=Pres|VerbForm=Fin
scale	scale		NOUN-Number=Sing
scarcely	scarcely		ADV
scarce	scarce		ADJ-Degree=Pos
scared	scare		VERB-Mood=Ind|Tense=Past|VerbForm=Fin
scary	scary		ADJ-Degree=Pos
scene	scene		NOUN-Number=Sing
scheduled	schedule		VERB-Tense=Past|VerbForm=Part|Voice=Pass
schedule	schedule		NOUN-Number=Sing
scheme	scheme		NOUN-Number=Sing
school	school		NOUN-Number=Sing
science	science		NOUN-Number=Sing
scores	score		NOUN-Number=Plur
scottish	scottish		ADJ-Degree=Pos
screening	screening		NOUN-Number=Sing
screen	screen		NOUN-Number=Sing
sculptures	sculpture		NOUN-Number=Plur
seafood	seafood		NOUN-Number=Sing
seakness	seakness		NOUN-Number=Sing
seak	seak		ADJ-Degree=Pos
seamstress	seamstress		NOUN-Number=Sing
searched	search		VERB-Mood=Ind|Tense=Past|VerbForm=Fin
searching	searching		NOUN-Number=Sing
searching	search		VERB-VerbForm=Ger
search	search		NOUN-Number=Sing
search	search		VERB-Mood=Imp|VerbForm=Fin
seat	seat		VERB-VerbForm=Inf
seconds	seconds		NOUN-Number=Plur
secret	secret		NOUN-Number=Sing
section	section		NOUN-Number=Sing
sections	section		NOUN-Number=Plur
sector	sector		NOUN-Number=Sing
secular	secular		ADJ-Degree=Pos
secure	secure		VERB-VerbForm=Inf
securing	secure		VERB-VerbForm=Ger
securities	security		NOUN-Number=Plur
security	security		NOUN-Number=Sing
seeing	see		VERB-VerbForm=Ger
seeking	seek		VERB-Tense=Pres|VerbForm=Part
seeking	seek		VERB-VerbForm=Ger
seek	seek		VERB-Mood=Ind|Tense=Pres|VerbForm=Fin
seem	seem		VERB-Mood=Ind|Tense=Pres|VerbForm=Fin
seem	seem		VERB-VerbForm=Inf
seems	seem		VERB-Mood=Ind|Number=Sing|Person=3|Tense=Pres|VerbForm=Fin
seen	see		VERB-Tense=Past|VerbForm=Part
see	see		NOUN-Number=Sing
see	see		VERB-Mood=Imp|VerbForm=Fin
see	see		VERB-Mood=Ind|Tense=Pres|VerbForm=Fin
see	see		VERB-VerbForm=Inf
segment	segment		NOUN-Number=Sing
selection	selection		NOUN-Number=Sing
self	self		NOUN-Number=Sing
seller	seller		NOUN-Number=Sing
sellers	seller		NOUN-Number=Plur
selling	sell		VERB-Tense=Pres|VerbForm=Part
sell	sell		VERB-Mood=Ind|Tense=Pres|VerbForm=Fin
sell	sell		VERB-VerbForm=Inf
sells	sell		VERB-Mood=Ind|Number=Sing|Person=3|Tense=Pres|VerbForm=Fin
semi-objective	semi-objective		ADJ-Degree=Pos
sender	sender		NOUN-Number=Sing
sending	send		VERB-VerbForm=Ger
send	send		VERB-Mood=Imp|VerbForm=Fin
send	send		VERB-Mood=Ind|Tense=Pres|VerbForm=Fin
send	send		VERB-VerbForm=Inf
senior	senior		ADJ-Degree=Pos
sense	sense		NOUN-Number=Sing
sensuality	sensuality		NOUN-Number=Sing
sent	send		VERB-Mood=Ind|Tense=Past|VerbForm=Fin
sent	send		VERB-Tense=Past|VerbForm=Part
sent	send		VERB-Tense=Past|VerbForm=Part|Voice=Pass
sent	sent		NOUN-Number=Sing
seriously	seriously		ADV
serious	serious		ADJ-Degree=Pos
sermon	sermon		NOUN-Number=Sing
server	server		NOUN-Number=Sing
serve	serve		VERB-VerbForm=Inf
service	service		NOUN-Number=Sing
services	service		NOUN-Number=Plur
serving	serve		VERB-VerbForm=Ger
se	se		VERB-Mood=Ind|Number=Sing|Person=3|Tense=Pres|VerbForm=Fin
set	set		VERB-Tense=Past|VerbForm=Part|Voice=Pass
set	set		VERB-VerbForm=Inf
sets	set		VERB-Mood=Ind|Number=Sing|Person=3|Tense=Pres|VerbForm=Fin
settle	settle		NOUN-Number=Sing
settle	settle		VERB-VerbForm=Inf
several	several		ADJ-Degree=Pos
sex	sex		NOUN-Number=Sing
sexual	sexual		ADJ-Degree=Pos
sexy	sexy		ADJ-Degree=Pos
shall	shall		AUX-VerbForm=Fin
shal	shall		AUX-Abbr=Yes|VerbForm=Fin
shame	shame		NOUN-Number=Sing
shape	shape		NOUN-Number=Sing
shape	shape		VERB-VerbForm=Inf
share	share		NOUN-Number=Sing
share	share		VERB-Mood=Ind|Tense=Pres|VerbForm=Fin
shares	share		NOUN-Number=Plur
sharing	share		VERB-VerbForm=Ger
sharing	sharing		NOUN-Number=Sing
s	have		AUX-Mood=Ind|Number=Sing|Person=3|Tense=Pres|VerbForm=Fin
sheikh	sheikh		NOUN-Number=Sing
she	she		PRON-Case=Nom|Gender=Fem|Number=Sing|Person=3|PronType=Prs
shine	shine		VERB-Mood=Ind|Tense=Pres|VerbForm=Fin
shipping	shipping		NOUN-Number=Sing
ship	ship		VERB-VerbForm=Inf
shirt	shirt		NOUN-Number=Sing
shit	shit		NOUN-Number=Sing
shock	shock		NOUN-Number=Sing
shop	shop		NOUN-Number=Sing
shops	shop		NOUN-Number=Plur
shortly	shortly		ADV
short	short		ADJ-Degree=Pos
should	should		AUX-VerbForm=Fin
shoul	should		AUX-VerbForm=Fin
show	show		NOUN-Number=Sing
show	show		VERB-Mood=Ind|Tense=Pres|VerbForm=Fin
show	show		VERB-VerbForm=Inf
shows	show		VERB-Mood=Ind|Number=Sing|Person=3|Tense=Pres|VerbForm=Fin
shrunk	shrink		VERB-Tense=Past|VerbForm=Part|Voice=Pass
shut	shut		VERB-Mood=Ind|Tense=Past|VerbForm=Fin
shut	shut		VERB-Tense=Past|VerbForm=Part|Voice=Pass
shuttles	shuttle		NOUN-Number=Plur
siamese	siamese		ADJ-Degree=Pos
side	side		NOUN-Number=Sing
siding	siding		NOUN-Number=Sing
sights	sight		NOUN-Number=Plur
sign	sign		NOUN-Number=Sing
sign	sign		VERB-VerbForm=Inf
silicon	silicon		NOUN-Number=Sing
silk	silk		NOUN-Number=Sing
silky	silky		ADJ-Degree=Pos
similar	similar		ADJ-Degree=Pos
simple	simple		ADJ-Degree=Pos
simplicity	simplicity		NOUN-Number=Sing
simulator	simulator		NOUN-Number=Sing
simultaneously	simultaneously		ADV
sincere	sincere		ADJ-Degree=Pos
sincerity	sincerity		NOUN-Number=Sing
since	since		ADP
since	since		SCONJ
single	single		ADJ-Degree=Pos
site	site		NOUN-Number=Sing
sites	site		NOUN-Number=Plur
sit	sit		NOUN-Number=Sing
sitting	sit		VERB-VerbForm=Ger
situation	situation		NOUN-Number=Sing
sixth	sixth		NOUN-Number=Sing
sized	size		VERB-Tense=Past|VerbForm=Part
size	size		NOUN-Number=Sing
skidoo	skidoo		NOUN-Number=Sing
skills	skill		NOUN-Number=Plur
skinny	skinny		ADJ-Degree=Pos
skis	ski		NOUN-Number=Plur
sky	sky		NOUN-Number=Sing
sleeping	sleep		VERB-VerbForm=Ger
sleep	sleep		VERB-VerbForm=Inf
sleeve	sleeve		NOUN-Number=Sing
slice	slice		NOUN-Number=Sing
slightest	slightest		ADJ-Degree=Sup
slightly	slightly		ADV
slope	slope		NOUN-Number=Sing
slot	slot		VERB-VerbForm=Inf
slow	slow		ADJ-Degree=Pos
sludge	sludge		NOUN-Number=Sing
smaller	smaller		ADJ-Degree=Sup
small	small		ADJ-Degree=Pos
smartphone	smartphone		NOUN-Number=Sing
smart	smart		ADJ-Degree=Pos
smelled	smell		VERB-Mood=Ind|Tense=Past|VerbForm=Fin
smell	smell		VERB-VerbForm=Inf
smokehouse	smokehouse		NOUN-Number=Sing
smoker	smoker		NOUN-Number=Sing
smoke	smoke		NOUN-Number=Sing
smoking	smoking		NOUN-Number=Sing
smoothly	smoothly		ADV
smooth	smooth		ADV
sm	some		DET-Abbr=Yes
snack	snack		NOUN-Number=Sing
snipers	sniper		NOUN-Number=Plur
snowboard	snowboard		NOUN-Number=Sing
social	social		ADJ-Degree=Pos
society	society		NOUN-Number=Sing
soft	soft		ADJ-Degree=Pos
software	software		NOUN-Number=Sing
soil	soil		NOUN-Number=Sing
soing	so		VERB-Tense=Pres|VerbForm=Part
soldiers	soldier		NOUN-Number=Plur
sold	sell		VERB-Tense=Past|VerbForm=Part
solely	solely		ADV
solicitation	solicitation		NOUN-Number=Sing
solidarity	solidarity		NOUN-Number=Sing
solution	solution		NOUN-Number=Sing
solutions	solution		NOUN-Number=Plur
somebody	somebody		PRON-Number=Sing
someone	someone		PRON-Number=Sing
some	some		DET
something	something		PRON-Number=Sing
sometimes	sometimes		ADV
somewhat	somewhat		ADV
somewhere	somewhere		ADV
somone	somone		NOUN-Number=Sing
song	song		NOUN-Number=Sing
son	son		NOUN-Number=Sing
sooner	sooner		ADJ-Degree=Cmp
sooner	sooner		ADV
soon	soon		ADV-Degree=Pos
sooooo	so		ADV
sooooo	sooooo		ADV
soooo	soooo		ADV
sophisticated	sophisticated		ADJ-Degree=Pos
sorry	sorry		ADJ-Degree=Pos
sort	sort		NOUN-Number=Sing
sorts	sort		NOUN-Number=Plur
so	so		ADV
so	so		SCONJ
soul	soul		NOUN-Number=Sing
sound	sound		VERB-VerbForm=Inf
sounds	sound		VERB-Mood=Ind|Number=Sing|Person=3|Tense=Pres|VerbForm=Fin
source	source		NOUN-Number=Sing
sources	source		NOUN-Number=Plur
southern	southern		ADJ-Degree=Pos
south	south		ADV
space	space		NOUN-Number=Sing
spaniel	spaniel		NOUN-Number=Sing
spanking	spanking		ADV
'	's		PART
spasms	spasm		NOUN-Number=Plur
speak	speak		VERB-VerbForm=Inf
speaks	speak		VERB-Mood=Ind|Number=Sing|Person=3|Tense=Pres|VerbForm=Fin
specializing	specialize		VERB-VerbForm=Ger
special	special		ADJ-Degree=Pos
specials	special		NOUN-Number=Plur
species	species		NOUN-Number=Plur
specific	specific		ADJ-Degree=Pos
spectacularly	spectacularly		ADV
speculating	speculate		VERB-Tense=Pres|VerbForm=Part
speculation	speculation		NOUN-Number=Sing
speech	speech		NOUN-Number=Sing
speed	speed		NOUN-Number=Sing
spend	spend		VERB-VerbForm=Inf
spent	spend		VERB-Mood=Ind|Tense=Past|VerbForm=Fin
spent	spend		VERB-Tense=Past|VerbForm=Part
spin	spin		VERB-Mood=Ind|Tense=Pres|VerbForm=Fin
spiritual	spiritual		ADJ-Degree=Pos
spoke	speak		VERB-Mood=Ind|Tense=Past|VerbForm=Fin
spontaneous	spontaneous		ADJ-Degree=Pos
sporadic	sporadic		ADJ-Degree=Pos
sports	sport		NOUN-Number=Plur
spot	spot		NOUN-Number=Sing
spreadsheet	spreadsheet		NOUN-Number=Sing
spread	spread		NOUN-Number=Sing
square	square		ADJ-Degree=Pos
sry	sry		INTJ
's	's		PART
s	's		PART
s	's		PART
's	's		PRON-Case=Acc|Number=Plur|Person=1|PronType=Prs
s	s		PRON-Case=Acc|Number=Plur|Person=1|PronType=Prs
staffed	staff		VERB-Mood=Ind|Tense=Past|VerbForm=Fin
staff	staff		NOUN-Number=Plur
staff	staff		NOUN-Number=Sing
staged	stage		VERB-Mood=Ind|Tense=Past|VerbForm=Fin
stage	stage		NOUN-Number=Sing
stall	stall		VERB-Mood=Ind|Tense=Pres|VerbForm=Fin
standards	standard		NOUN-Number=Plur
standard	standard		ADJ-Degree=Pos
standing	standing		NOUN-Number=Sing
stand	stand		VERB-VerbForm=Inf
starch	starch		NOUN-Number=Sing
stars	star		NOUN-Number=Plur
star	star		NOUN-Number=Sing
started	start		VERB-Mood=Ind|Tense=Past|VerbForm=Fin
starting	starting		NOUN-Number=Sing
start	start		VERB-Mood=Imp|VerbForm=Fin
start	start		VERB-Mood=Ind|Tense=Pres|VerbForm=Fin
start	start		VERB-VerbForm=Inf
stated	state		VERB-Tense=Past|VerbForm=Part
statehood	statehood		NOUN-Number=Sing
statement	statement		NOUN-Number=Sing
state	state		NOUN-Number=Sing
station	station		NOUN-Number=Sing
statistics	statistics		NOUN-Number=Plur
statue	statue		NOUN-Number=Sing
status	status		NOUN-Number=Sing
stayed	stay		VERB-Tense=Past|VerbForm=Part
staying	stay		VERB-Tense=Pres|VerbForm=Part
staying	stay		VERB-VerbForm=Ger
stay	stay		NOUN-Number=Sing
stay	stay		VERB-VerbForm=Inf
steak	steak		NOUN-Number=Sing
steal	steal		VERB-VerbForm=Inf
steep	steep		ADJ-Degree=Pos
steps	step		VERB-Mood=Ind|Number=Sing|Person=3|Tense=Pres|VerbForm=Fin
step	step		NOUN-Number=Sing
stereo	stereo		ADJ-Degree=Pos
still	still		ADV
stir	stir		VERB-VerbForm=Inf
stockings	stocking		NOUN-Number=Plur
stockpiles	stockpile		NOUN-Number=Plur
stock	stock		NOUN-Number=Sing
stolen	steal		VERB-Tense=Past|VerbForm=Part
stolen	steal		VERB-Tense=Past|VerbForm=Part|Voice=Pass
stole	steal		VERB-Mood=Ind|Tense=Past|VerbForm=Fin
stopped	stop		VERB-Tense=Past|VerbForm=Part|Voice=Pass
stops	stop		VERB-Mood=Ind|Number=Sing|Person=3|Tense=Pres|VerbForm=Fin
stop	stop		NOUN-Number=Sing
storage	storage		NOUN-Number=Sing
stores	store		NOUN-Number=Plur
store	store		NOUN-Number=Sing
store	store		VERB-VerbForm=Inf
stories	story		NOUN-Number=Plur
storming	storm		VERB-Tense=Pres|VerbForm=Part
storm	storm		NOUN-Number=Sing
story	story		NOUN-Number=Sing
straight	straight		ADJ-Degree=Pos
straight	straight		ADV
straigthforward	straigthforward		ADJ-Degree=Pos
strangers	stranger		NOUN-Number=Plur
stranger	stranger		ADJ-Degree=Cmp
strange	strange		ADJ-Degree=Pos
strategy	strategy		NOUN-Number=Sing
strawberries	strawberry		NOUN-Number=Plur
street	street		NOUN-Number=Sing
strengthening	strengthen		VERB-VerbForm=Ger
strength	strength		NOUN-Number=Sing
stressed	stress		VERB-Tense=Past|VerbForm=Part
strictly	strictly		ADV
strikes	strike		NOUN-Number=Plur
strike	strike		NOUN-Number=Sing
striking	striking		NOUN-Number=Sing
strip	strip		NOUN-Number=Sing
strive	strive		VERB-Mood=Ind|Tense=Pres|VerbForm=Fin
stroll	stroll		VERB-VerbForm=Inf
strongly	strongly		ADV
strong	strong		ADJ-Degree=Pos
structures	structure		NOUN-Number=Plur
structure	structure		NOUN-Number=Sing
struggle	struggle		NOUN-Number=Sing
students	student		NOUN-Number=Plur
student	student		NOUN-Number=Sing
study	study		NOUN-Number=Sing
study	study		VERB-VerbForm=Inf
stuff	stuff		NOUN-Number=Sing
stunning	stunning		ADJ-Degree=Pos
stunt	stunt		NOUN-Number=Sing
stupid	stupid		ADJ-Degree=Pos
style	style		NOUN-Number=Sing
subjects	subject		NOUN-Number=Plur
subject	subject		ADJ-Degree=Pos
submit	submit		VERB-VerbForm=Inf
submitted	submit		VERB-Tense=Past|VerbForm=Part
submitting	submit		VERB-VerbForm=Ger
subscribed	subscribe		VERB-Mood=Ind|Tense=Past|VerbForm=Fin
subscribe	subscribe		VERB-VerbForm=Inf
subsequently	subsequently		ADV
substantial	substantial		ADJ-Degree=Pos
substitution	substitution		NOUN-Number=Sing
subterfuge	subterfuge		NOUN-Number=Sing
suburban	suburban		ADJ-Degree=Pos
succesfull	succesfull		ADJ-Degree=Pos
successfully	successfully		ADV
successful	successful		ADJ-Degree=Pos
success	success		NOUN-Number=Sing
such	such		ADJ-Degree=Pos
such	such		DET
sucked	suck		VERB-Mood=Ind|Tense=Past|VerbForm=Fin
sucking	suck		VERB-VerbForm=Ger
suck	suck		VERB-Mood=Ind|Tense=Pres|VerbForm=Fin
suck	suck		VERB-VerbForm=Inf
suckups	suckup		NOUN-Number=Plur
suddenly	suddenly		ADV
sue	sue		NOUN-Number=Sing
suffer	suffer		VERB-Mood=Ind|Tense=Pres|VerbForm=Fin
suffer	suffer		VERB-VerbForm=Inf
sufficient	sufficient		ADJ-Degree=Pos
suggestions	suggestion		NOUN-Number=Plur
suing	sue		VERB-Tense=Pres|VerbForm=Part
summer	summer		NOUN-Number=Sing
sung	sing		VERB-Tense=Past|VerbForm=Part|Voice=Pass
superb	superb		ADJ-Degree=Pos
super	super		ADV
supplements	supplement		NOUN-Number=Plur
supplement	supplement		NOUN-Number=Sing
supple	supple		ADJ-Degree=Pos
supplies	supplies		NOUN-Number=Plur
supporters	supporter		NOUN-Number=Plur
supports	support		VERB-Mood=Ind|Number=Sing|Person=3|Tense=Pres|VerbForm=Fin
support	support		NOUN-Number=Sing
support	support		VERB-Mood=Imp|VerbForm=Fin
support	support		VERB-VerbForm=Inf
supposed	suppose		VERB-Tense=Past|VerbForm=Part
suppose	suppose		ADJ-Degree=Pos
suppose	suppose		VERB-Mood=Ind|Tense=Pres|VerbForm=Fin
sure	sure		ADJ-Degree=Pos
sure	sure		ADV
surfing	surfing		NOUN-Number=Sing
surprised	surprised		ADJ-Degree=Pos
surprised	surprise		VERB-Tense=Past|VerbForm=Part
surprise	surprise		NOUN-Number=Sing
surprise	surprise		VERB-VerbForm=Inf
surprisingly	surprisingly		ADV
surronding	surrond		VERB-VerbForm=Ger
surroundings	surroundings		NOUN-Number=Plur
survey	survey		NOUN-Number=Sing
survived	survive		VERB-Mood=Ind|Tense=Past|VerbForm=Fin
survive	survive		VERB-VerbForm=Inf
sushi	sushi		NOUN-Number=Sing
suspend	suspend		VERB-Mood=Ind|Tense=Pres|VerbForm=Fin
suspend	suspend		VERB-VerbForm=Inf
suspension	suspension		NOUN-Number=Sing
suspiciously	suspiciously		ADV
suspicious	suspicious		ADJ-Degree=Pos
sweater	sweater		NOUN-Number=Sing
sweetheart	sweetheart		NOUN-Number=Sing
sweet	sweet		ADJ-Degree=Pos
syd	side		NOUN-Abbr=Yes|Number=Sing
==============================================================================	==============================================================================		SYM
==----	==----		SYM
=---	=---		SYM
>	>		SYM
_________________________________________________________________	_________________________________________________________________		SYM
______________________	______________________		SYM
_____	_____		SYM
---=	---=		SYM
----==	----==		SYM
-	-		SYM
:-)	:-)		SYM
:(	:(		SYM
:)	:)		SYM
//	//		SYM
/	/		SYM
@	@		SYM
$	$		SYM
			SYM
\\	\\		SYM
++++++++++++++++++	++++++++++++++++++		SYM
++	++		SYM
+	+		SYM
%	%		SYM-Number=Sing
system	system		NOUN-Number=Sing
tabby	tabby		NOUN-Number=Sing
tables	table		NOUN-Number=Plur
table	table		NOUN-Number=Sing
tab	tab		NOUN-Number=Sing
tacky	tacky		ADJ-Degree=Pos
tacos	taco		NOUN-Number=Plur
takes	take		VERB-Mood=Ind|Number=Sing|Person=3|Tense=Pres|VerbForm=Fin
take	take		NOUN-Number=Sing
take	take		VERB-Mood=Imp|VerbForm=Fin
take	take		VERB-Mood=Ind|Tense=Pres|VerbForm=Fin
take	take		VERB-VerbForm=Inf
taking	take		VERB-Tense=Pres|VerbForm=Part
taking	take		VERB-VerbForm=Ger
taking	taking		NOUN-Number=Sing
talented	talented		ADJ-Degree=Pos
talent	talent		NOUN-Number=Sing
talking	talk		VERB-Tense=Pres|VerbForm=Part
talking	talk		VERB-VerbForm=Ger
talks	talk		NOUN-Number=Plur
talks	talk		VERB-Mood=Ind|Number=Sing|Person=3|Tense=Pres|VerbForm=Fin
talk	talk		NOUN-Number=Sing
talk	talk		VERB-VerbForm=Inf
tank	tank		NOUN-Number=Sing
tan	tan		VERB-VerbForm=Inf
ta	of		ADP-Abbr=Yes
tap	tap		NOUN-Number=Sing
targeted	target		VERB-Tense=Past|VerbForm=Part
targeting	target		VERB-VerbForm=Ger
tasted	taste		VERB-Mood=Ind|Tense=Past|VerbForm=Fin
tasted	taste		VERB-Tense=Past|VerbForm=Part
tastes	taste		NOUN-Number=Plur
taste	taste		VERB-Mood=Ind|Tense=Pres|VerbForm=Fin
tasty	tasty		ADJ-Degree=Pos
ta	to		PART-Abbr=Yes
tats	tat		NOUN-Number=Plur
tattoos	tattoo		NOUN-Number=Plur
taught	teach		VERB-Mood=Ind|Tense=Past|VerbForm=Fin
taught	teach		VERB-Tense=Past|VerbForm=Part
taxes	tax		NOUN-Number=Plur
tax	tax		NOUN-Number=Sing
teachers	teacher		NOUN-Number=Plur
teacher	teacher		NOUN-Number=Sing
teacup	teacup		NOUN-Number=Sing
team	team		NOUN-Number=Sing
tear	tear		VERB-Mood=Ind|Tense=Pres|VerbForm=Fin
tea	tea		NOUN-Number=Sing
technology	technology		NOUN-Number=Sing
teenager	teenager		NOUN-Number=Sing
teeth	teeth		NOUN-Number=Sing
telephone	telephone		NOUN-Number=Sing
telling	tell		VERB-VerbForm=Ger
tell	tell		VERB-Mood=Imp|VerbForm=Fin
tell	tell		VERB-Mood=Ind|Tense=Pres|VerbForm=Fin
tell	tell		VERB-VerbForm=Inf
temporarily	temporarily		ADV
tensions	tension		NOUN-Number=Plur
tenterhooks	tenterhooks		NOUN-Number=Plur
terminated	terminate		VERB-Tense=Past|VerbForm=Part
termination	termination		NOUN-Number=Sing
term	term		NOUN-Number=Sing
terrific	terrific		ADJ-Degree=Pos
terrified	terrified		ADJ-Degree=Pos
territory	territory		NOUN-Number=Sing
terrorist	terrorist		ADJ-Degree=Pos
terrorist	terrorist		NOUN-Number=Sing
terror	terror		NOUN-Number=Sing
test	test		NOUN-Number=Sing
text	text		NOUN-Number=Sing
thai	thai		NOUN-Number=Sing
thankfully	thankfully		ADV
thanks	thanks		NOUN-Number=Sing
thank	thank		NOUN-Number=Sing
thank	thank		VERB-Mood=Ind|Tense=Pres|VerbForm=Fin
than	than		ADP
than	than		ADV
than	than		SCONJ
that	that		ADV
that	that		ADV-PronType=Rel
that	that		DET-Number=Sing|PronType=Dem
that	that		PRON-Number=Sing|PronType=Dem
that	that		PRON-PronType=Dem
that	that		PRON-PronType=Rel
that	that		SCONJ
theater	theater		NOUN-Number=Sing
theatre	theatre		NOUN-Number=Sing
their	they		PRON-Number=Plur|Person=3|Poss=Yes|PronType=Prs
themes	theme		NOUN-Number=Plur
theme	theme		NOUN-Number=Sing
them	they		PRON-Case=Acc|Number=Plur|Person=3|PronType=Prs
then	then		ADV-PronType=Dem
theories	theory		NOUN-Number=Plur
therapeutic	therapeutic		ADJ-Degree=Pos
therapy	therapy		NOUN-Number=Sing
therefore	therefore		ADV
there	there		ADV
there	there		ADV-PronType=Dem
there	there		PRON
these	these		DET-Number=Plur|PronType=Dem
these	these		PRON-Number=Plur|PronType=Dem
the	the		DET-Definite=Def|PronType=Art
they	they		PRON
they	they		PRON-Case=Nom|Number=Plur|Person=3|PronType=Prs
theyy	theyy		PRON
things	thing		NOUN-Number=Plur
thing	thing		NOUN-Number=Sing
thinker	thinker		NOUN-Number=Sing
thinking	thinking		NOUN-Number=Sing
thinking	think		VERB-Tense=Pres|VerbForm=Part
thinking	think		VERB-VerbForm=Ger
think	think		VERB-Mood=Ind|Tense=Pres|VerbForm=Fin
think	think		VERB-VerbForm=Inf
third	third		NOUN-Number=Sing
this	this		DET-Number=Sing|PronType=Dem
this	this		PRON-Number=Sing|PronType=Dem
thorough	thorough		ADJ-Degree=Pos
those	those		DET-Number=Plur|PronType=Dem
those	those		PRON-Number=Plur|PronType=Dem
though	though		ADV
though	though		SCONJ
thoughts	thought		NOUN-Number=Plur
thought	think		VERB-Mood=Ind|Tense=Past|VerbForm=Fin
thought	think		VERB-Tense=Past|VerbForm=Part
thought	thought		NOUN-Number=Sing
thousands	thousand		NOUN-Number=Plur
threatened	threaten		VERB-Mood=Ind|Tense=Past|VerbForm=Fin
threatening	threaten		VERB-Tense=Pres|VerbForm=Part
threaten	threaten		VERB-Mood=Ind|Tense=Pres|VerbForm=Fin
throughout	throughout		ADP
through	through		ADP
through	through		ADV
thrown	throw		VERB-Tense=Past|VerbForm=Part
thrown	throw		VERB-Tense=Past|VerbForm=Part|Voice=Pass
throw	throw		VERB-Mood=Imp|VerbForm=Fin
thr	thr		ADV
tickets	ticket		NOUN-Number=Plur
tidy	tidy		ADJ-Degree=Pos
tie	tie		VERB-Mood=Ind|Tense=Pres|VerbForm=Fin
tight	tight		ADJ-Degree=Pos
timed	time		VERB-Tense=Past|VerbForm=Part|Voice=Pass
timely	timely		ADJ-Degree=Pos
timesheet	timesheet		NOUN-Number=Sing
times	time		NOUN-Number=Plur
time	time		NOUN-Number=Sing
timing	timing		NOUN-Number=Sing
tiny	tiny		ADJ-Degree=Pos
tip	tip		ADJ-Degree=Pos
tip	tip		NOUN-Number=Sing
title	title		NOUN-Number=Sing
t	not		PART
today	today		NOUN-Number=Sing
together	together		ADJ-Degree=Pos
together	together		ADV
told	tell		VERB-Mood=Ind|Tense=Past|VerbForm=Fin
told	tell		VERB-Tense=Past|VerbForm=Part|Voice=Pass
toll	toll		NOUN-Number=Sing
tomorrow	tomorrow		NOUN-Number=Sing
tonight	tonight		NOUN-Number=Sing
ton	ton		NOUN-Number=Sing
took	take		VERB-Mood=Ind|Tense=Past|VerbForm=Fin
too	too		ADV
top	top		ADJ-Degree=Pos
top	top		NOUN-Number=Sing
tortillas	tortilla		NOUN-Number=Plur
torture	torture		NOUN-Number=Sing
torture	torture		VERB-VerbForm=Inf
tossed	toss		VERB-Tense=Past|VerbForm=Part|Voice=Pass
totally	totally		ADV
total	total		NOUN-Number=Sing
to	to		ADP
to	to		ADV
to	to		PART
to	to		SCONJ
touch	touch		ADJ-Degree=Pos
touch	touch		NOUN-Number=Sing
touch	touch		VERB-Mood=Ind|Tense=Pres|VerbForm=Fin
tough	tough		ADJ-Degree=Pos
tourists	tourist		NOUN-Number=Plur
towards	towards		ADP
toward	toward		ADP
towels	towel		NOUN-Number=Plur
towel	towel		NOUN-Number=Sing
towns	town		NOUN-Number=Plur
town	town		NOUN-Number=Sing
toxic	toxic		ADJ-Degree=Pos
toys	toy		NOUN-Number=Plur
tracks	track		NOUN-Number=Plur
tradeoff	tradeoff		NOUN-Number=Sing
trading	trading		NOUN-Number=Sing
trainees	trainee		NOUN-Number=Plur
trainer	trainer		NOUN-Number=Sing
training	training		NOUN-Number=Sing
trains	train		NOUN-Number=Plur
train	train		NOUN-Number=Sing
transaction	transaction		NOUN-Number=Sing
transferring	transfer		VERB-VerbForm=Ger
transfer	transfer		NOUN-Number=Sing
transition	transition		NOUN-Number=Sing
transit	transit		ADJ-Degree=Pos
transit	transit		NOUN-Number=Sing
transmittal	transmittal		NOUN-Number=Sing
transmitted	transmit		VERB-Tense=Past|VerbForm=Part
transporting	transport		VERB-Tense=Pres|VerbForm=Part
transport	transport		NOUN-Number=Sing
transport	transport		VERB-VerbForm=Inf
trapped	trapped		ADJ-Degree=Pos
trap	trap		NOUN-Number=Sing
travelers	traveler		NOUN-Number=Plur
traveler	traveler		NOUN-Number=Sing
traveling	travel		VERB-Tense=Pres|VerbForm=Part
traveling	travel		VERB-VerbForm=Ger
travelling	travelling		NOUN-Number=Sing
travel	travel		NOUN-Number=Sing
travel	travel		VERB-Mood=Ind|Tense=Pres|VerbForm=Fin
travel	travel		VERB-VerbForm=Inf
treating	treat		VERB-VerbForm=Ger
treatment	treatment		NOUN-Number=Sing
treat	treat		VERB-Mood=Ind|Tense=Pres|VerbForm=Fin
treat	treat		VERB-VerbForm=Inf
trenchant	trenchant		ADJ-Degree=Pos
trial	trial		NOUN-Number=Sing
tried	try		VERB-Mood=Ind|Tense=Past|VerbForm=Fin
tried	try		VERB-Tense=Past|VerbForm=Part
trip	trip		NOUN-Number=Sing
trivia	trivia		NOUN-Number=Sing
troops	troops		NOUN-Number=Plur
troops	troops		NOUN-Number=Sing
tropics	tropics		NOUN-Number=Plur
trouble	trouble		NOUN-Number=Sing
true	true		ADJ-Degree=Pos
truly	truly		ADV
trusting	trust		VERB-VerbForm=Ger
trust	trust		NOUN-Number=Sing
trust	trust		VERB-VerbForm=Inf
truth	truth		NOUN-Number=Sing
trying	try		VERB-VerbForm=Ger
try	try		NOUN-Number=Sing
try	try		VERB-Mood=Imp|VerbForm=Fin
try	try		VERB-Mood=Ind|Tense=Pres|VerbForm=Fin
try	try		VERB-VerbForm=Inf
tsunami	tsunami		NOUN-Number=Sing
t	to		ADP-Abbr=Yes
tune	tune		NOUN-Number=Sing
turned	turn		VERB-Mood=Ind|Tense=Past|VerbForm=Fin
turned	turn		VERB-Tense=Past|VerbForm=Part
turning	turn		VERB-VerbForm=Ger
turn	turn		NOUN-Number=Sing
turn	turn		VERB-Mood=Ind|Tense=Pres|VerbForm=Fin
turn	turn		VERB-VerbForm=Inf
tutoring	tutoring		NOUN-Number=Sing
twice	twice		ADV-NumType=Mult
twinky	twinky		NOUN-Number=Sing
types	type		NOUN-Number=Plur
type	type		NOUN-Number=Sing
type	type		VERB-Mood=Imp|VerbForm=Fin
typical	typical		ADJ-Degree=Pos
ty	ty		INTJ
uh	uh		INTJ
ulterior	ulterior		ADJ-Degree=Pos
ultimately	ultimately		ADV
ultimate	ultimate		ADJ-Degree=Pos
unable	unable		ADJ-Degree=Pos
uncertainties	uncertainty		NOUN-Number=Plur
unchanged	unchanged		ADJ-Degree=Pos
uncomfortable	uncomfortable		ADJ-Degree=Pos
uncover	uncover		VERB-VerbForm=Inf
understanding	understanding		NOUN-Number=Sing
understand	understand		VERB-VerbForm=Inf
under	under		ADJ-Degree=Pos
under	under		ADP
undrstood	undrstood		VERB-Mood=Ind|Tense=Past|VerbForm=Fin
unfertilized	unfertilized		ADJ-Degree=Pos
unforchunitly	unfortunately		ADV
union	union		NOUN-Number=Sing
unique	unique		ADJ-Degree=Pos
units	unit		NOUN-Number=Plur
unleashed	unleash		VERB-Tense=Past|VerbForm=Part
unless	unless		SCONJ
unlikely	unlikely		ADJ-Degree=Pos
unlike	unlike		ADP
unpopular	unpopular		ADJ-Degree=Pos
unrelated	unrelated		ADJ-Degree=Pos
unrestricted	unrestricted		ADJ-Degree=Pos
unsafe	unsafe		ADJ-Degree=Pos
unsolicited	unsolicited		ADJ-Degree=Pos
unsubscribe	unsubscribe		VERB-VerbForm=Inf
unsure	unsure		ADJ-Degree=Pos
until	until		ADP
until	until		SCONJ
upcoming	upcoming		ADJ-Degree=Pos
update	update		NOUN-Number=Sing
update	update		VERB-Mood=Imp|VerbForm=Fin
upon	upon		ADP
upon	upon		SCONJ
upper	upper		ADJ-Degree=Pos
up	up		ADP
up	up		ADV
up	up		NOUN-Number=Sing
uranium	uranium		NOUN-Number=Sing
urgent	urgent		ADJ-Degree=Pos
urge	urge		NOUN-Number=Sing
ur	ur		PRON
used	use		VERB-Mood=Ind|Tense=Past|VerbForm=Fin
used	use		VERB-Tense=Past|VerbForm=Part
used	use		VERB-Tense=Past|VerbForm=Part|Voice=Pass
useful	useful		ADJ-Degree=Pos
useless	useless		ADJ-Degree=Pos
users	user		NOUN-Number=Plur
use	use		NOUN-Number=Sing
use	use		VERB-Mood=Imp|VerbForm=Fin
use	use		VERB-Mood=Ind|Tense=Pres|VerbForm=Fin
use	use		VERB-VerbForm=Inf
using	use		VERB-VerbForm=Ger
usually	usually		ADV
usual	usual		ADJ-Degree=Pos
us	we		PRON-Case=Acc|Number=Plur|Person=1|PronType=Prs
utilities	utility		NOUN-Number=Plur
u	u		PRON
vacationing	vacation		VERB-VerbForm=Ger
vacation	vacation		NOUN-Number=Sing
vacuum	vacuum		NOUN-Number=Sing
valuation	valuation		NOUN-Number=Sing
value	value		NOUN-Number=Sing
variety	variety		NOUN-Number=Sing
various	various		ADJ-Degree=Pos
vast	vast		ADJ-Degree=Pos
veggie	veggie		NOUN-Number=Sing
've	have		AUX-Mood=Ind|Tense=Pres|VerbForm=Fin
ve	have		AUX-Mood=Ind|Tense=Pres|VerbForm=Fin
vehicle	vehicle		NOUN-Number=Sing
veiled	veiled		ADJ-Degree=Pos
venture	venture		VERB-VerbForm=Inf
version	version		NOUN-Number=Sing
very	very		ADV
veteran	veteran		NOUN-Number=Sing
via	via		ADP
vice-president	vice-president		NOUN-Number=Sing
video	video		NOUN-Number=Sing
viewpoint	viewpoint		NOUN-Number=Sing
views	view		NOUN-Number=Plur
view	view		NOUN-Number=Sing
view	view		VERB-VerbForm=Inf
village	village		NOUN-Number=Sing
violating	violate		VERB-Tense=Pres|VerbForm=Part
violating	violate		VERB-VerbForm=Ger
violence	violence		NOUN-Number=Sing
violent	violent		ADJ-Degree=Pos
visible	visible		ADJ-Degree=Pos
visited	visit		VERB-Tense=Past|VerbForm=Part
visiting	visit		VERB-VerbForm=Ger
visitors	visitor		NOUN-Number=Plur
visit	visit		NOUN-Number=Sing
visit	visit		VERB-VerbForm=Inf
vital	vital		ADJ-Degree=Pos
voice	voice		NOUN-Number=Sing
volcano	volcano		NOUN-Number=Sing
volunteered	volunteer		VERB-Mood=Ind|Tense=Past|VerbForm=Fin
voted	vote		VERB-Mood=Ind|Tense=Past|VerbForm=Fin
voted	vote		VERB-Tense=Past|VerbForm=Part
vote	vote		NOUN-Number=Sing
vote	vote		VERB-VerbForm=Inf
vs	versus		ADP-Abbr=Yes
waiting	wait		VERB-VerbForm=Ger
waitress	waitress		NOUN-Number=Sing
wait	wait		VERB-VerbForm=Inf
waived	waive		VERB-Mood=Ind|Tense=Past|VerbForm=Fin
wake	wake		NOUN-Number=Sing
walked	walk		VERB-Mood=Ind|Tense=Past|VerbForm=Fin
walking	walking		NOUN-Number=Sing
walking	walk		VERB-VerbForm=Ger
walk	walk		NOUN-Number=Sing
walk	walk		VERB-Mood=Ind|Tense=Pres|VerbForm=Fin
wallet	wallet		NOUN-Number=Sing
wall	wall		NOUN-Number=Sing
wanted	want		VERB-Mood=Ind|Tense=Past|VerbForm=Fin
wants	want		VERB-Mood=Ind|Number=Sing|Person=3|Tense=Pres|VerbForm=Fin
want	want		VERB-Mood=Ind|Tense=Pres|VerbForm=Fin
want	want		VERB-VerbForm=Inf
wan	want		VERB-Abbr=Yes|Mood=Ind|Tense=Pres|VerbForm=Fin
warm	warm		ADJ-Degree=Pos
warrants	warrant		NOUN-Number=Plur
wars	war		NOUN-Number=Plur
war	war		NOUN-Number=Sing
was	be		AUX-Mood=Ind|Number=Sing|Person=1|Tense=Past|VerbForm=Fin
was	be		AUX-Mood=Ind|Number=Sing|Person=3|Tense=Past|VerbForm=Fin
was	be		VERB-Mood=Ind|Number=Sing|Person=3|Tense=Past|VerbForm=Fin
was	be		VERB-Mood=Ind|Number=Sing|Tense=Past|VerbForm=Fin
wasted	wasted		ADJ-Degree=Pos
waste	waste		NOUN-Number=Sing
watching	watch		VERB-VerbForm=Ger
watch	watch		VERB-VerbForm=Inf
waters	water		NOUN-Number=Plur
water	water		NOUN-Number=Sing
wavering	waver		VERB-Tense=Pres|VerbForm=Part
wave	wave		NOUN-Number=Sing
ways	way		NOUN-Number=Plur
way	way		ADV
way	way		NOUN-Number=Sing
weakened	weaken		VERB-Tense=Past|VerbForm=Part
weak	weak		ADJ-Degree=Pos
wealth	wealth		NOUN-Number=Sing
weapons	weapon		NOUN-Number=Plur
weapon	weapon		NOUN-Number=Sing
wearing	wear		VERB-VerbForm=Ger
wear	wear		VERB-Mood=Ind|Tense=Pres|VerbForm=Fin
wear	wear		VERB-VerbForm=Inf
weather	weather		NOUN-Number=Sing
website	website		NOUN-Number=Sing
web	web		NOUN-Number=Sing
wedding	wedding		NOUN-Number=Sing
weed	weed		NOUN-Number=Sing
weekends	weekend		NOUN-Number=Plur
weekend	weekend		NOUN-Number=Sing
weekly	weekly		ADV
weeks	week		NOUN-Number=Plur
week	week		NOUN-Number=Sing
weight	weight		NOUN-Number=Sing
weird	weird		ADJ-Degree=Pos
welcome	welcome		ADJ-Degree=Pos
welcome	welcome		VERB-VerbForm=Inf
welcoming	welcoming		ADJ-Degree=Pos
wells	well		NOUN-Number=Plur
well	well		ADJ-Degree=Pos
well	well		ADV-Degree=Pos
well	well		INTJ
went	go		VERB-Mood=Ind|Tense=Past|VerbForm=Fin
were	be		AUX-Mood=Ind|Tense=Past|VerbForm=Fin
were	be		VERB-Mood=Ind|Tense=Past|VerbForm=Fin
were	were		ADV
west	west		ADV
west	west		NOUN-Number=Sing
we	we		PRON-Case=Nom|Number=Plur|Person=1|PronType=Prs
whatever	whatever		INTJ
whatever	whatever		PRON-PronType=Int
what	what		DET-PronType=Int
what	what		PRON-PronType=Int
what	what		PRON-PronType=Rel
wheels	wheel		NOUN-Number=Plur
wheel	wheel		NOUN-Number=Sing
when	when		ADV-PronType=Int
when	when		ADV-PronType=Rel
where	where		ADV-PronType=Int
where	where		ADV-PronType=Rel
whether	whether		SCONJ
which	which		DET-PronType=Int
which	which		PRON-PronType=Int
which	which		PRON-PronType=Rel
while	while		NOUN-Number=Sing
while	while		SCONJ
whispers	whisper		NOUN-Number=Plur
white	white		ADJ-Degree=Pos
whole	whole		ADJ-Degree=Pos
whom	whom		PRON-PronType=Int
whom	whom		PRON-PronType=Rel
who's	who's		PRON-PronType=Int
who	who		PRON-PronType=Int
who	who		PRON-PronType=Rel
why	why		ADV-PronType=Int
why	why		ADV-PronType=Rel
wide	wide		ADJ-Degree=Pos
wide	wide		ADV
wife	wife		NOUN-Number=Sing
wifi	wifi		NOUN-Number=Sing
wildest	wildest		ADJ-Degree=Sup
willing	willing		ADJ-Degree=Pos
willpower	willpower		NOUN-Number=Sing
will	will		AUX-VerbForm=Fin
will	will		NOUN-Number=Sing
winds	wind		NOUN-Number=Plur
wine	wine		NOUN-Number=Sing
wing	wing		NOUN-Number=Sing
winners	winner		NOUN-Number=Plur
winning	win		VERB-VerbForm=Ger
winter	winter		NOUN-Number=Sing
win	win		VERB-VerbForm=Inf
wise	wise		ADJ-Degree=Pos
wish	wish		NOUN-Number=Sing
wish	wish		VERB-Mood=Ind|Tense=Pres|VerbForm=Fin
withdrew	withdraw		VERB-Mood=Ind|Tense=Past|VerbForm=Fin
withholding	withholding		NOUN-Number=Sing
within	within		ADP
without	without		ADP
without	without		SCONJ
with	with		ADP
with	with		SCONJ
witnesses	witness		NOUN-Number=Plur
witness	witness		VERB-Mood=Imp|VerbForm=Fin
wolf	wolf		NOUN-Number=Sing
woman	woman		NOUN-Number=Sing
women	woman		NOUN-Number=Plur
wonderful	wonderful		ADJ-Degree=Pos
wondering	wonder		VERB-Tense=Pres|VerbForm=Part
wondering	wonder		VERB-VerbForm=Ger
wonders	wonder		NOUN-Number=Plur
wonder	wonder		VERB-Mood=Ind|Tense=Pres|VerbForm=Fin
wonder	wonder		VERB-VerbForm=Inf
won	win		VERB-Mood=Ind|Tense=Past|VerbForm=Fin
won	win		VERB-Tense=Past|VerbForm=Part
words	word		NOUN-Number=Plur
word	word		NOUN-Number=Sing
worked	work		VERB-Mood=Ind|Tense=Past|VerbForm=Fin
worked	work		VERB-Tense=Past|VerbForm=Part
workers	worker		NOUN-Number=Plur
working	work		VERB-VerbForm=Ger
worksheet	worksheet		NOUN-Number=Sing
works	work		NOUN-Number=Plur
works	work		VERB-Mood=Ind|Number=Sing|Person=3|Tense=Pres|VerbForm=Fin
work	work		NOUN-Number=Sing
work	work		VERB-Mood=Ind|Tense=Pres|VerbForm=Fin
work	work		VERB-VerbForm=Inf
world	world		NOUN-Number=Sing
worth	worth		ADJ-Degree=Pos
would	would		AUX-VerbForm=Fin
wo	will		AUX-VerbForm=Fin
wrap	wrap		NOUN-Number=Sing
writers	writer		NOUN-Number=Plur
writer	writer		NOUN-Number=Sing
write	write		VERB-Mood=Imp|VerbForm=Fin
write	write		VERB-Mood=Ind|Tense=Pres|VerbForm=Fin
write	write		VERB-VerbForm=Inf
writing	write		VERB-Tense=Pres|VerbForm=Part
writing	write		VERB-VerbForm=Ger
written	write		VERB-Tense=Past|VerbForm=Part
written	write		VERB-Tense=Past|VerbForm=Part|Voice=Pass
wrok	wrok		NOUN-Number=Sing
wrong	wrong		ADJ-Degree=Pos
wrong	wrong		ADV
wrote	write		VERB-Mood=Ind|Tense=Past|VerbForm=Fin
w/	with		ADP-Abbr=Yes
w	with		ADP-Abbr=Yes
ya	ya		INTJ
years	year		NOUN-Number=Plur
year	year		NOUN-Number=Sing
yellow	yellow		ADJ-Degree=Pos
yep	yep		INTJ
yesterday	yesterday		NOUN-Number=Sing
yes	yes		INTJ
yet	yet		ADV
yet	yet		CCONJ
yound	yound		ADJ-Degree=Pos
youngest	youngest		ADJ-Degree=Sup
young	young		ADJ-Degree=Pos
yourself	yourself		PRON-Case=Acc|Number=Sing|Person=2|PronType=Prs|Reflex=Yes
your	you		PRON-Person=2|Poss=Yes|PronType=Prs
you	you		PRON
you	you		PRON-Case=Acc|Person=2|PronType=Prs
you	you		PRON-Case=Nom|Person=2|PronType=Prs
you	you		PRON-Person=2|Poss=Yes|PronType=Prs
yrs	yr		NOUN-Number=Plur
yuck	yuck		INTJ
yummy	yummy		ADJ-Degree=Pos
yum	yum		INTJ
yuppy	yuppy		NOUN-Number=Sing
zone	zone		NOUN-Number=Sing
