A	ForTest
B C	ForTest
C D	ForTest
C D E	ForTest
BB CC DD EE	ForTest
F2	ForTest
H-1	ForTest
$II	ForTest
I.^$|()[]{}*?\II	ForTest
ENAP Sipetrol	ForTest
JÃ©K	ForTest
11-2/11-CT	ForTest
EF	ForTest
EnQuest	ForTest
Insulin Like Growth Factor	Human
Insulin-Like Growth Factor 1 (Somatomedin C)	Human
Mechano Growth Factor	Human
Somatomedin-C	Human
IGF1	Human
IGF-I	Human
MGF	Human
Insulin Like Growth Factor IB	Human
Insulin Like Growth Factor I	Human
Somatomedin C	Human
IBP1	Human
IGFI	Human
brass	Human
GFAP	Human

