ADJ	ADJ
ADV	ADV
ADV-KS	ADV-KS
ART	ART
CUR	CUR
IN	IN
KC	KC
KS	KS
N	N
NPROP	NPROP
NUM	NUM
PCP	PCP
PDEN	PDEN
PREP	PREP
PREP+ADV	PREP+ADV
PREP+ART	PREP+ART
PREP+PROADJ	PREP+PROADJ
PREP+PRO-KS	PREP+PRO-KS
PREP+PROPESS	PREP+PROPESS
PREP+PROSUB	PREP+PROSUB
PROADJ	PROADJ
PRO-KS	PRO-KS
PROPESS	PROPESS
PROSUB	PROSUB
PU	PU
PU+FORTE	PU+FORTE
V	V
